Player,Nation,Pos,Age,90s,tackles_Tkl,tackles_TklW,tackles_Def 3rd,tackles_Mid 3rd,tackles_Att 3rd,challenges_Tkl,challenges_Att,challenges_Tkl%,challenges_Lost,blocks_Blocks,blocks_Sh,blocks_Pass,Int,Tkl+Int,Clr,Err,Matches,Team,Season
David Raya,es ESP,GK,29-243,36.0,0,0,0,0,0,0,2,0.0,2,0,0,0,2,2,19,6,Matches,Arsenal,2024
William Saliba,fr FRA,DF,24-053,33.3,62,37,37,23,2,21,28,75.0,7,25,15,10,21,83,116,6,Matches,Arsenal,2024
Declan Rice,eng ENG,MF,26-122,29.4,52,24,21,25,6,16,37,43.2,21,24,11,13,25,77,44,0,Matches,Arsenal,2024
Thomas Partey,gh GHA,"MF,DF",31-337,29.1,84,51,24,38,22,44,72,61.1,28,26,7,19,34,118,47,4,Matches,Arsenal,2024
Gabriel Magalhães,br BRA,DF,27-148,26.3,25,15,12,8,5,12,16,75.0,4,42,29,13,16,41,93,2,Matches,Arsenal,2024
Leandro Trossard,be BEL,FW,30-163,27.0,28,19,5,14,9,10,32,31.3,22,32,0,32,9,37,17,0,Matches,Arsenal,2024
Jurriën Timber,nl NED,DF,23-333,26.9,58,38,17,30,11,18,27,66.7,9,19,4,15,22,80,44,1,Matches,Arsenal,2024
Martin Ødegaard,no NOR,MF,26-150,24.7,19,11,9,7,3,4,24,16.7,20,5,0,5,5,24,5,1,Matches,Arsenal,2024
Gabriel Martinelli,br BRA,"FW,MF",23-332,23.7,20,15,8,5,7,7,23,30.4,16,12,0,12,4,24,17,0,Matches,Arsenal,2024
Kai Havertz,de GER,"FW,MF",25-339,20.4,16,9,3,6,7,4,15,26.7,11,22,4,18,6,22,31,1,Matches,Arsenal,2024
Bukayo Saka,eng ENG,"FW,MF",23-253,18.1,24,13,7,10,7,11,22,50.0,11,22,0,22,3,27,8,0,Matches,Arsenal,2024
Mikel Merino,es ESP,"MF,FW",28-328,16.6,43,26,7,24,12,18,33,54.5,15,18,5,13,15,58,25,2,Matches,Arsenal,2024
Myles Lewis-Skelly,eng ENG,DF,18-232,14.0,22,14,10,9,3,10,10,100.0,0,2,1,1,6,28,23,0,Matches,Arsenal,2024
Ben White,eng ENG,DF,27-220,11.3,17,11,10,4,3,14,31,45.2,17,9,7,2,16,33,36,0,Matches,Arsenal,2024
Riccardo Calafiori,it ITA,DF,22-362,10.4,26,18,15,9,2,18,29,62.1,11,12,6,6,9,35,25,0,Matches,Arsenal,2024
Ethan Nwaneri,eng ENG,"FW,MF",18-056,9.1,11,7,4,4,3,7,18,38.9,11,8,2,6,2,13,4,1,Matches,Arsenal,2024
Jorginho,it ITA,MF,33-147,7.8,12,4,1,7,4,8,20,40.0,12,3,0,3,7,19,2,2,Matches,Arsenal,2024
Jakub Kiwior,pl POL,DF,25-090,10.5,15,7,8,5,2,10,13,76.9,3,8,5,3,4,19,41,2,Matches,Arsenal,2024
Gabriel Jesus,br BRA,FW,28-043,6.8,10,6,4,3,3,4,9,44.4,5,10,1,9,4,14,8,0,Matches,Arsenal,2024
Raheem Sterling,eng ENG,"FW,MF",30-159,4.9,8,4,1,2,5,4,8,50.0,4,3,0,3,1,9,3,0,Matches,Arsenal,2024
Oleksandr Zinchenko,ua UKR,"DF,MF",28-152,5.1,4,1,1,2,1,2,7,28.6,5,6,1,5,4,8,6,0,Matches,Arsenal,2024
Kieran Tierney,sct SCO,"DF,FW",27-345,2.2,6,5,4,1,1,4,6,66.7,2,0,0,0,2,8,5,0,Matches,Arsenal,2024
Nathan Butler-Oyedeji,eng ENG,FW,22-132,0.1,0,0,0,0,0,0,0,,0,0,0,0,0,0,0,0,Matches,Arsenal,2024
Takehiro Tomiyasu,jp JPN,DF,26-192,0.1,0,0,0,0,0,0,0,,0,0,0,0,0,0,1,0,Matches,Arsenal,2024
Reiss Nelson,eng ENG,FW,25-157,0.0,1,0,0,1,0,0,1,0.0,1,0,0,0,0,1,1,0,Matches,Arsenal,2024
Emiliano Martínez,ar ARG,GK,32-256,34.0,3,3,3,0,0,2,2,100.0,0,1,0,1,0,3,17,6,Matches,Aston Villa,2024
Youri Tielemans,be BEL,MF,28-009,33.3,83,57,31,44,8,40,73,54.8,33,37,16,21,22,105,47,4,Matches,Aston Villa,2024
Morgan Rogers,eng ENG,"FW,MF",22-294,32.7,40,21,15,14,11,22,44,50.0,22,26,7,19,5,45,20,2,Matches,Aston Villa,2024
Ezri Konsa,eng ENG,DF,27-205,30.6,32,17,19,9,4,18,23,78.3,5,18,10,8,21,53,107,4,Matches,Aston Villa,2024
Ollie Watkins,eng ENG,FW,29-137,26.9,10,7,0,6,4,3,11,27.3,8,11,3,8,8,18,15,2,Matches,Aston Villa,2024
Lucas Digne,fr FRA,DF,31-300,26.1,65,38,40,16,9,44,66,66.7,22,23,4,19,25,90,89,1,Matches,Aston Villa,2024
John McGinn,sct SCO,"MF,FW",30-210,23.0,31,22,10,13,8,11,29,37.9,18,21,2,19,14,45,17,3,Matches,Aston Villa,2024
Matty Cash,pl POL,DF,27-282,21.0,50,29,26,20,4,25,36,69.4,11,20,8,12,21,71,63,2,Matches,Aston Villa,2024
Pau Torres,es ESP,DF,28-120,20.4,20,14,11,7,2,9,15,60.0,6,14,10,4,9,29,66,2,Matches,Aston Villa,2024
Jacob Ramsey,eng ENG,"FW,MF",23-353,17.7,30,15,14,10,6,10,20,50.0,10,23,4,19,8,38,8,1,Matches,Aston Villa,2024
Boubacar Kamara,fr FRA,MF,25-174,17.3,49,20,28,17,4,28,55,50.9,27,17,7,10,19,68,50,3,Matches,Aston Villa,2024
Amadou Onana,be BEL,MF,23-273,16.3,49,24,22,23,4,14,27,51.9,13,15,7,8,25,74,41,3,Matches,Aston Villa,2024
Leon Bailey,jm JAM,"FW,MF",27-280,12.6,6,4,1,3,2,2,10,20.0,8,6,0,6,3,9,12,0,Matches,Aston Villa,2024
Tyrone Mings,eng ENG,DF,32-064,12.4,7,6,6,1,0,2,2,100.0,0,13,11,2,7,14,61,1,Matches,Aston Villa,2024
Ian Maatsen,nl NED,DF,23-067,10.7,27,15,16,8,3,16,22,72.7,6,11,0,11,15,42,34,2,Matches,Aston Villa,2024
Diego Carlos,br BRA,DF,32-062,9.2,8,3,6,1,1,4,6,66.7,2,13,7,6,5,13,36,2,Matches,Aston Villa,2024
Marco Asensio,es ESP,MF,29-115,6.8,7,5,0,7,0,3,9,33.3,6,4,0,4,2,9,3,0,Matches,Aston Villa,2024
Axel Disasi,fr FRA,DF,27-066,5.4,8,5,7,1,0,3,7,42.9,4,4,1,3,5,13,18,0,Matches,Aston Villa,2024
Lamare Bogarde,nl NED,"DF,MF",21-131,5.3,14,6,6,6,2,10,16,62.5,6,5,3,2,1,15,13,0,Matches,Aston Villa,2024
Andrés García,es ESP,"DF,MF",22-098,3.5,9,5,5,3,1,4,8,50.0,4,2,0,2,2,11,10,2,Matches,Aston Villa,2024
Jáder Durán,co COL,FW,21-154,7.1,8,7,1,2,5,1,4,25.0,3,5,0,5,0,8,13,0,Matches,Aston Villa,2024
Marcus Rashford,eng ENG,FW,27-197,4.9,10,7,2,3,5,4,6,66.7,2,2,0,2,1,11,3,0,Matches,Aston Villa,2024
Ross Barkley,eng ENG,MF,31-162,6.3,14,3,4,10,0,9,14,64.3,5,9,3,6,10,24,5,0,Matches,Aston Villa,2024
Jaden Philogene Bidace,eng ENG,"FW,MF",23-097,3.7,11,5,4,7,0,4,6,66.7,2,5,0,5,3,14,2,1,Matches,Aston Villa,2024
Donyell Malen,nl NED,FW,26-127,3.3,7,4,3,3,1,1,4,25.0,3,1,0,1,0,7,1,0,Matches,Aston Villa,2024
Robin Olsen,se SWE,GK,35-128,2.0,1,0,1,0,0,1,1,100.0,0,0,0,0,0,1,2,1,Matches,Aston Villa,2024
Kosta Nedeljković,rs SRB,DF,19-151,1.4,7,5,1,3,3,2,3,66.7,1,1,0,1,0,7,3,0,Matches,Aston Villa,2024
Emi Buendía,ar ARG,"MF,FW",28-142,1.1,6,6,3,2,1,0,5,0.0,5,5,1,4,0,6,2,0,Matches,Aston Villa,2024
Milos Kerkez,hu HUN,DF,21-190,35.2,52,26,25,20,7,24,38,63.2,14,36,11,25,44,96,103,3,Matches,Bournemouth,2024
Antoine Semenyo,gh GHA,FW,25-129,33.6,53,34,16,24,13,16,42,38.1,26,61,8,53,10,63,38,2,Matches,Bournemouth,2024
Illia Zabarnyi,ua UKR,DF,22-257,32.5,48,33,28,19,1,32,47,68.1,15,33,20,13,39,87,175,2,Matches,Bournemouth,2024
Lewis Cook,eng ENG,"MF,DF",28-102,32.3,81,42,41,36,4,37,67,55.2,30,30,11,19,40,121,68,0,Matches,Bournemouth,2024
Kepa Arrizabalaga,es ESP,GK,30-225,29.0,1,0,1,0,0,0,2,0.0,2,1,0,1,0,1,15,3,Matches,Bournemouth,2024
Justin Kluivert,nl NED,"MF,FW",26-011,24.5,21,9,4,10,7,4,21,19.0,17,24,0,24,13,34,23,1,Matches,Bournemouth,2024
Ryan Christie,sct SCO,MF,30-083,23.5,54,33,19,27,8,27,64,42.2,37,44,11,33,30,84,51,3,Matches,Bournemouth,2024
Evanilson,br BRA,FW,25-222,23.9,16,10,6,5,5,8,12,66.7,4,11,2,9,0,16,21,0,Matches,Bournemouth,2024
Dean Huijsen,es ESP,DF,20-032,25.8,36,26,19,16,1,18,28,64.3,10,36,28,8,50,86,185,4,Matches,Bournemouth,2024
Dango Ouattara,bf BFA,FW,23-094,22.3,35,26,14,11,10,17,41,41.5,24,36,10,26,11,46,51,0,Matches,Bournemouth,2024
Tyler Adams,us USA,MF,26-091,19.8,78,48,24,47,7,36,68,52.9,32,33,10,23,32,110,40,0,Matches,Bournemouth,2024
Marcus Tavernier,eng ENG,"FW,MF",26-055,19.6,42,24,14,19,9,10,26,38.5,16,16,3,13,5,47,11,0,Matches,Bournemouth,2024
Adam Smith,eng ENG,DF,34-017,16.4,22,10,11,5,6,12,25,48.0,13,12,5,7,14,36,48,1,Matches,Bournemouth,2024
Marcos Senesi,ar ARG,DF,28-006,11.4,36,21,23,11,2,14,30,46.7,16,15,7,8,11,47,56,0,Matches,Bournemouth,2024
David Brooks,wls WAL,"FW,MF",27-312,9.5,12,5,2,7,3,1,14,7.1,13,16,2,14,5,17,8,1,Matches,Bournemouth,2024
Alex Scott,eng ENG,MF,21-268,8.4,27,14,11,8,8,19,42,45.2,23,17,4,13,10,37,15,0,Matches,Bournemouth,2024
James Hill,eng ENG,DF,23-126,5.0,15,8,6,6,3,3,11,27.3,8,5,0,5,9,24,31,0,Matches,Bournemouth,2024
Julian Araujo,mx MEX,DF,23-276,4.8,8,3,4,4,0,5,12,41.7,7,3,0,3,6,14,16,0,Matches,Bournemouth,2024
Mark Travers,ie IRL,GK,25-363,5.0,0,0,0,0,0,0,0,,0,0,0,0,0,0,5,0,Matches,Bournemouth,2024
Enes Ünal,tr TUR,"FW,MF",28-006,3.8,1,0,0,0,1,0,3,0.0,3,1,0,1,0,1,6,0,Matches,Bournemouth,2024
Neto,br BRA,GK,35-301,2.0,0,0,0,0,0,0,0,,0,0,0,0,0,0,1,1,Matches,Bournemouth,2024
Luis Sinisterra,co COL,"FW,MF",25-333,2.6,7,2,3,2,2,0,4,0.0,4,3,0,3,1,8,8,0,Matches,Bournemouth,2024
Philip Billing,dk DEN,MF,28-339,2.0,14,5,7,6,1,3,4,75.0,1,3,0,3,5,19,2,0,Matches,Bournemouth,2024
Max Aarons,eng ENG,DF,25-132,1.0,2,2,1,1,0,1,1,100.0,0,3,1,2,1,3,0,0,Matches,Bournemouth,2024
Daniel Jebbison,eng ENG,FW,21-276,0.9,3,2,2,1,0,3,5,60.0,2,2,1,1,1,4,1,0,Matches,Bournemouth,2024
Ben Winterburn,eng ENG,"FW,MF",20-254,0.3,0,0,0,0,0,0,1,0.0,1,0,0,0,2,2,0,0,Matches,Bournemouth,2024
Julio Soler,ar ARG,FW,20-089,0.0,1,1,1,0,0,1,1,100.0,0,1,0,1,0,1,0,0,Matches,Bournemouth,2024
Remy Rees-Dottin,eng ENG,FW,19-071,0.0,0,0,0,0,0,0,0,,0,0,0,0,0,0,0,0,Matches,Bournemouth,2024
Zain Silcott-Duberry,ms MSR,FW,19-311,0.0,1,1,0,0,1,1,1,100.0,0,0,0,0,0,1,0,0,Matches,Bournemouth,2024
Nathan Collins,ie IRL,DF,24-016,36.0,37,22,22,11,4,22,35,62.9,13,72,52,20,33,70,219,2,Matches,Brentford,2024
Bryan Mbeumo,cm CMR,FW,25-282,35.9,45,29,17,14,14,18,31,58.1,13,24,3,21,14,59,52,1,Matches,Brentford,2024
Mark Flekken,nl NED,GK,31-337,34.4,4,4,4,0,0,3,9,33.3,6,2,0,2,0,4,26,4,Matches,Brentford,2024
Keane Lewis-Potter,eng ENG,"DF,FW",24-083,32.5,46,26,25,15,6,28,46,60.9,18,26,9,17,19,65,72,3,Matches,Brentford,2024
Mikkel Damsgaard,dk DEN,"MF,FW",24-317,30.5,80,43,27,27,26,30,77,39.0,47,39,2,37,26,106,30,2,Matches,Brentford,2024
Yoane Wissa,cd COD,FW,28-255,30.4,22,12,6,8,8,11,27,40.7,16,29,8,21,8,30,20,3,Matches,Brentford,2024
Christian Nørgaard,dk DEN,MF,31-067,29.3,76,46,35,34,7,45,74,60.8,29,51,19,32,46,122,65,1,Matches,Brentford,2024
Sepp van den Berg,nl NED,DF,23-147,26.7,37,22,23,10,4,18,27,66.7,9,51,37,14,20,57,124,3,Matches,Brentford,2024
Vitaly Janelt,de GER,MF,27-006,25.0,38,22,14,13,11,21,36,58.3,15,33,9,24,27,65,53,1,Matches,Brentford,2024
Kevin Schade,de GER,FW,23-170,23.8,36,23,14,10,12,12,20,60.0,8,17,2,15,5,41,32,0,Matches,Brentford,2024
Ethan Pinnock,jm JAM,DF,31-352,21.3,35,19,15,16,4,13,24,54.2,11,29,18,11,24,59,142,4,Matches,Brentford,2024
Kristoffer Ajer,no NOR,DF,27-029,15.6,25,17,14,10,1,14,26,53.8,12,17,4,13,12,37,49,0,Matches,Brentford,2024
Yehor Yarmoliuk,ua UKR,MF,21-076,14.3,42,25,16,20,6,25,49,51.0,24,24,7,17,12,54,31,0,Matches,Brentford,2024
Mads Roerslev,dk DEN,DF,25-326,12.2,18,8,14,3,1,11,28,39.3,17,12,5,7,4,22,35,0,Matches,Brentford,2024
Mathias Jensen,dk DEN,MF,29-135,9.3,14,10,6,6,2,8,16,50.0,8,13,4,9,8,22,13,1,Matches,Brentford,2024
Michael Kayode,it ITA,DF,20-310,4.2,15,10,11,4,0,9,11,81.8,2,2,0,2,5,20,15,0,Matches,Brentford,2024
Fabio Carvalho,pt POR,"FW,MF",22-259,5.1,13,9,4,4,5,6,13,46.2,7,6,1,5,3,16,2,0,Matches,Brentford,2024
Ben Mee,eng ENG,DF,35-237,2.0,2,2,0,2,0,1,1,100.0,0,3,3,0,4,6,7,0,Matches,Brentford,2024
Thiago,br BRA,FW,23-324,1.6,4,3,1,1,2,0,1,0.0,1,2,0,2,2,6,2,1,Matches,Brentford,2024
Hákon Rafn Valdimarsson,is ISL,GK,23-215,1.6,0,0,0,0,0,0,0,,0,0,0,0,0,0,2,0,Matches,Brentford,2024
Edmond-Paris Maghoma,eng ENG,"MF,FW",24-008,1.3,2,1,0,2,0,1,3,33.3,2,2,2,0,1,3,2,0,Matches,Brentford,2024
Rico Henry,eng ENG,DF,27-312,0.9,0,0,0,0,0,0,4,0.0,4,3,1,2,1,1,2,0,Matches,Brentford,2024
Yunus Emre Konak,tr TUR,"FW,MF",19-126,0.5,4,4,0,4,0,1,2,50.0,1,2,0,2,0,4,0,0,Matches,Brentford,2024
Kim Jisoo,kr KOR,DF,20-143,0.3,0,0,0,0,0,0,0,,0,0,0,0,0,0,2,0,Matches,Brentford,2024
Frank Onyeka,ng NGA,MF,27-135,0.3,0,0,0,0,0,0,0,,0,0,0,0,0,0,0,0,Matches,Brentford,2024
Gustavo Nunes,br BRA,"FW,MF",19-177,0.1,3,2,2,0,1,2,2,100.0,0,0,0,0,0,3,2,0,Matches,Brentford,2024
Jayden Meghoma,eng ENG,DF,18-322,0.1,0,0,0,0,0,0,0,,0,0,0,0,0,0,0,0,Matches,Brentford,2024
Ryan Trevitt,eng ENG,MF,22-065,0.0,1,1,1,0,0,0,0,,0,0,0,0,0,1,0,0,Matches,Brentford,2024
Bart Verbruggen,nl NED,GK,22-271,34.0,0,0,0,0,0,0,3,0.0,3,1,0,1,0,0,28,5,Matches,Brighton and Hove Albion,2024
Jan Paul van Hecke,nl NED,DF,24-342,30.9,41,27,21,19,1,21,39,53.8,18,33,19,14,23,64,138,2,Matches,Brighton and Hove Albion,2024
Carlos Baleba,cm CMR,MF,21-133,27.6,73,42,25,33,15,46,76,60.5,30,44,10,34,43,116,42,1,Matches,Brighton and Hove Albion,2024
Kaoru Mitoma,jp JPN,"FW,MF",27-361,28.1,44,26,15,13,16,19,48,39.6,29,48,3,45,13,57,10,0,Matches,Brighton and Hove Albion,2024
Pervis Estupiñán,ec ECU,DF,27-115,25.7,60,40,31,22,7,32,47,68.1,15,17,3,14,36,96,63,2,Matches,Brighton and Hove Albion,2024
Lewis Dunk,eng ENG,DF,33-176,23.1,17,10,8,7,2,11,19,57.9,8,28,18,10,13,30,79,2,Matches,Brighton and Hove Albion,2024
Danny Welbeck,eng ENG,FW,34-171,22.6,24,15,6,13,5,7,19,36.8,12,18,3,15,5,29,14,0,Matches,Brighton and Hove Albion,2024
João Pedro,br BRA,"FW,MF",23-232,21.6,16,12,6,6,4,4,11,36.4,7,12,0,12,9,25,12,0,Matches,Brighton and Hove Albion,2024
Jack Hinshelwood,eng ENG,"DF,MF",20-035,19.4,26,18,8,10,8,11,27,40.7,16,8,3,5,15,41,37,1,Matches,Brighton and Hove Albion,2024
Yasin Ayari,se SWE,MF,21-222,20.5,56,31,15,30,11,23,53,43.4,30,23,6,17,20,76,25,0,Matches,Brighton and Hove Albion,2024
Joël Veltman,nl NED,DF,33-121,18.5,42,28,23,16,3,30,51,58.8,21,22,7,15,18,60,66,0,Matches,Brighton and Hove Albion,2024
Georginio Rutter,fr FRA,"MF,FW",23-026,18.4,39,15,13,18,8,14,36,38.9,22,20,3,17,10,49,13,2,Matches,Brighton and Hove Albion,2024
Yankuba Minteh,gm GAM,"FW,MF",20-298,18.5,47,34,25,13,9,17,45,37.8,28,21,0,21,11,58,31,0,Matches,Brighton and Hove Albion,2024
Matt O'Riley,dk DEN,MF,24-176,10.1,16,9,4,8,4,4,13,30.8,9,7,3,4,13,29,9,1,Matches,Brighton and Hove Albion,2024
Simon Adingra,ci CIV,"FW,MF",23-135,11.0,23,14,10,8,5,10,24,41.7,14,12,0,12,8,31,6,2,Matches,Brighton and Hove Albion,2024
Tariq Lamptey,gh GHA,DF,24-228,9.6,17,11,8,9,0,9,25,36.0,16,15,7,8,7,24,23,1,Matches,Brighton and Hove Albion,2024
Igor,br BRA,DF,27-098,10.0,4,4,2,1,1,4,10,40.0,6,23,14,9,4,8,39,1,Matches,Brighton and Hove Albion,2024
Adam Webster,eng ENG,DF,30-132,7.9,9,6,5,3,1,5,12,41.7,7,12,9,3,18,27,33,1,Matches,Brighton and Hove Albion,2024
Mats Wieffer,nl NED,"MF,DF",25-181,9.3,46,27,20,22,4,26,38,68.4,12,15,1,14,14,60,24,3,Matches,Brighton and Hove Albion,2024
Brajan Gruda,de GER,"MF,FW",20-350,6.0,14,6,6,5,3,7,14,50.0,7,8,0,8,2,16,5,1,Matches,Brighton and Hove Albion,2024
Ferdi Kadioglu,tr TUR,"DF,MF",25-221,4.3,10,6,4,5,1,6,15,40.0,9,2,2,0,8,18,17,0,Matches,Brighton and Hove Albion,2024
Diego Gómez,py PAR,MF,22-050,5.0,17,10,8,7,2,9,19,47.4,10,12,0,12,7,24,10,1,Matches,Brighton and Hove Albion,2024
James Milner,eng ENG,MF,39-132,1.9,5,2,1,3,1,3,3,100.0,0,4,2,2,2,7,2,1,Matches,Brighton and Hove Albion,2024
Julio Enciso,py PAR,"MF,FW",21-113,3.3,0,0,0,0,0,0,2,0.0,2,2,0,2,0,0,1,0,Matches,Brighton and Hove Albion,2024
Evan Ferguson,ie IRL,FW,20-209,2.7,4,3,0,3,1,2,5,40.0,3,3,1,2,0,4,4,0,Matches,Brighton and Hove Albion,2024
Jason Steele,eng ENG,GK,34-271,2.0,0,0,0,0,0,0,0,,0,0,0,0,0,0,1,0,Matches,Brighton and Hove Albion,2024
Solly March,eng ENG,"FW,MF",30-300,1.9,6,3,2,2,2,5,8,62.5,3,3,0,3,2,8,2,1,Matches,Brighton and Hove Albion,2024
Billy Gilmour,sct SCO,MF,23-339,1.1,3,3,2,1,0,3,4,75.0,1,1,0,1,0,3,1,0,Matches,Brighton and Hove Albion,2024
Eiran Cashin,ie IRL,DF,23-188,0.2,0,0,0,0,0,0,1,0.0,1,0,0,0,0,0,2,0,Matches,Brighton and Hove Albion,2024
Jakub Moder,pl POL,MF,26-039,0.1,1,0,1,0,0,0,2,0.0,2,0,0,0,0,1,3,0,Matches,Brighton and Hove Albion,2024
Jeremy Sarmiento,ec ECU,MF,22-334,0.1,0,0,0,0,0,0,0,,0,0,0,0,0,0,0,0,Matches,Brighton and Hove Albion,2024
Moisés Caicedo,ec ECU,"MF,DF",23-195,35.2,107,67,40,52,15,51,82,62.2,31,46,10,36,49,156,56,1,Matches,Chelsea,2024
Cole Palmer,eng ENG,MF,23-010,33.5,28,17,11,10,7,9,23,39.1,14,15,1,14,11,39,18,1,Matches,Chelsea,2024
Levi Colwill,eng ENG,DF,22-079,33.0,45,32,24,18,3,17,26,65.4,9,36,25,11,32,77,108,4,Matches,Chelsea,2024
Marc Cucurella,es ESP,DF,26-298,31.2,61,39,30,26,5,27,54,50.0,27,46,15,31,25,86,86,3,Matches,Chelsea,2024
Enzo Fernández,ar ARG,MF,24-119,30.7,64,32,17,29,18,31,84,36.9,53,38,7,31,13,77,22,4,Matches,Chelsea,2024
Robert Sánchez,es ESP,GK,27-179,30.0,0,0,0,0,0,0,1,0.0,1,0,0,0,2,2,22,9,Matches,Chelsea,2024
Nicolas Jackson,sn SEN,FW,23-330,24.7,22,13,6,7,9,5,10,50.0,5,15,2,13,3,25,15,0,Matches,Chelsea,2024
Noni Madueke,eng ENG,FW,23-067,20.6,22,15,7,12,3,13,36,36.1,23,17,0,17,8,30,11,0,Matches,Chelsea,2024
Pedro Neto,pt POR,FW,25-068,23.4,22,9,9,9,4,8,19,42.1,11,14,2,12,9,31,6,0,Matches,Chelsea,2024
Malo Gusto,fr FRA,DF,21-362,20.5,44,28,27,15,2,25,48,52.1,23,29,8,21,24,68,48,5,Matches,Chelsea,2024
Jadon Sancho,eng ENG,FW,25-052,18.9,11,7,3,2,6,5,12,41.7,7,10,0,10,2,13,6,2,Matches,Chelsea,2024
Wesley Fofana,fr FRA,DF,24-150,13.0,13,12,6,7,0,6,14,42.9,8,14,9,5,14,27,55,2,Matches,Chelsea,2024
Tosin Adarabioyo,eng ENG,DF,27-234,13.7,14,10,10,4,0,8,12,66.7,4,9,7,2,10,24,62,0,Matches,Chelsea,2024
Trevoh Chalobah,eng ENG,DF,25-315,10.1,11,7,5,6,0,7,8,87.5,1,6,3,3,10,21,48,1,Matches,Chelsea,2024
Roméo Lavia,be BEL,MF,21-130,8.4,22,13,5,13,4,10,21,47.6,11,6,0,6,16,38,10,1,Matches,Chelsea,2024
Reece James,eng ENG,"DF,MF",25-159,9.8,9,9,5,3,1,3,9,33.3,6,12,4,8,13,22,18,4,Matches,Chelsea,2024
Christopher Nkunku,fr FRA,FW,27-183,10.2,12,8,3,4,5,6,8,75.0,2,9,2,7,7,19,10,0,Matches,Chelsea,2024
Filip Jørgensen,dk DEN,GK,23-030,6.0,0,0,0,0,0,0,0,,0,0,0,0,0,0,0,3,Matches,Chelsea,2024
Axel Disasi,fr FRA,DF,27-066,4.0,7,4,5,1,1,6,11,54.5,5,4,1,3,2,9,11,1,Matches,Chelsea,2024
João Félix,pt POR,"FW,MF",25-187,4.1,8,3,2,5,1,5,9,55.6,4,2,0,2,3,11,2,0,Matches,Chelsea,2024
Benoît Badiashile,fr FRA,DF,24-051,3.7,9,6,5,4,0,4,5,80.0,1,2,2,0,6,15,12,2,Matches,Chelsea,2024
Kiernan Dewsbury-Hall,eng ENG,"MF,FW",26-252,2.9,8,5,1,1,6,4,6,66.7,2,2,0,2,1,9,8,1,Matches,Chelsea,2024
Joshua Acheampong,eng ENG,DF,19-011,1.9,2,1,2,0,0,2,2,100.0,0,1,0,1,1,3,2,0,Matches,Chelsea,2024
Renato Veiga,pt POR,"DF,MF",21-291,2.0,9,6,6,3,0,4,12,33.3,8,3,1,2,1,10,2,0,Matches,Chelsea,2024
Mykhailo Mudryk,ua UKR,FW,24-131,1.7,2,2,2,0,0,0,0,,0,3,1,2,0,2,1,0,Matches,Chelsea,2024
Tyrique George,eng ENG,FW,19-101,1.1,2,0,2,0,0,2,3,66.7,1,0,0,0,1,3,1,0,Matches,Chelsea,2024
Marc Guiu,es ESP,FW,19-132,0.8,1,1,0,1,0,1,1,100.0,0,0,0,0,0,1,0,0,Matches,Chelsea,2024
Mathis Amougou,fr FRA,MF,19-118,0.1,0,0,0,0,0,0,0,,0,0,0,0,0,0,0,0,Matches,Chelsea,2024
Shumaira Mheuka,eng ENG,MF,17-208,0.0,0,0,0,0,0,0,0,,0,0,0,0,0,0,0,0,Matches,Chelsea,2024
Dean Henderson,eng ENG,GK,28-065,36.0,2,1,2,0,0,2,6,33.3,4,0,0,0,0,2,22,0,Matches,Crystal Palace,2024
Tyrick Mitchell,eng ENG,DF,25-257,33.4,88,54,55,26,7,23,43,53.5,20,63,12,51,14,102,100,2,Matches,Crystal Palace,2024
Daniel Muñoz,co COL,DF,28-355,33.9,115,75,54,38,23,52,92,56.5,40,37,4,33,41,156,104,1,Matches,Crystal Palace,2024
Marc Guéhi,eng ENG,DF,24-307,34.0,61,34,36,23,2,31,47,66.0,16,55,23,32,28,89,162,2,Matches,Crystal Palace,2024
Maxence Lacroix,fr FRA,DF,25-040,32.6,67,40,51,15,1,32,47,68.1,15,44,19,25,52,119,191,2,Matches,Crystal Palace,2024
Jean-Philippe Mateta,fr FRA,FW,27-322,28.6,17,12,4,11,2,3,16,18.8,13,18,4,14,2,19,22,0,Matches,Crystal Palace,2024
Eberechi Eze,eng ENG,"MF,FW",26-321,28.0,39,22,14,16,9,17,36,47.2,19,27,0,27,11,50,9,3,Matches,Crystal Palace,2024
Ismaila Sarr,sn SEN,MF,27-080,28.4,21,10,9,9,3,7,23,30.4,16,25,8,17,9,30,37,0,Matches,Crystal Palace,2024
Jefferson Lerma,co COL,"MF,DF",30-203,23.3,32,16,13,15,4,19,35,54.3,16,35,16,19,37,69,65,1,Matches,Crystal Palace,2024
Will Hughes,eng ENG,MF,30-029,22.1,62,33,18,31,13,27,59,45.8,32,31,14,17,21,83,24,3,Matches,Crystal Palace,2024
Chris Richards,us USA,DF,25-049,19.4,44,28,21,17,6,23,39,59.0,16,37,13,24,19,63,101,0,Matches,Crystal Palace,2024
Adam Wharton,eng ENG,MF,20-348,14.6,34,14,14,16,4,17,44,38.6,27,11,2,9,20,54,27,0,Matches,Crystal Palace,2024
Daichi Kamada,jp JPN,MF,28-284,16.2,46,28,19,23,4,14,39,35.9,25,22,5,17,16,62,14,0,Matches,Crystal Palace,2024
Trevoh Chalobah,eng ENG,DF,25-315,11.8,20,16,7,12,1,12,23,52.2,11,19,9,10,19,39,57,3,Matches,Crystal Palace,2024
Eddie Nketiah,eng ENG,"FW,MF",25-351,10.3,14,7,6,4,4,6,12,50.0,6,10,1,9,2,16,11,0,Matches,Crystal Palace,2024
Nathaniel Clyne,eng ENG,"DF,MF",34-041,5.4,12,8,8,3,1,6,11,54.5,5,4,2,2,3,15,14,1,Matches,Crystal Palace,2024
Cheick Doucouré,ml MLI,MF,25-128,5.0,16,8,6,8,2,5,11,45.5,6,4,0,4,11,27,10,1,Matches,Crystal Palace,2024
Justin Devenny,nir NIR,MF,21-217,4.8,14,9,6,7,1,7,14,50.0,7,3,0,3,0,14,10,0,Matches,Crystal Palace,2024
Odsonne Édouard,fr FRA,"MF,FW",27-120,1.3,1,0,0,1,0,0,2,0.0,2,1,0,1,0,1,1,0,Matches,Crystal Palace,2024
Joachim Andersen,dk DEN,DF,28-350,1.0,1,1,1,0,0,1,2,50.0,1,0,0,0,0,1,7,0,Matches,Crystal Palace,2024
Chadi Riad,ma MAR,DF,21-333,1.0,5,2,2,2,1,2,3,66.7,1,0,0,0,2,7,0,0,Matches,Crystal Palace,2024
Ben Chilwell,eng ENG,DF,28-146,1.9,5,5,2,3,0,0,4,0.0,4,4,2,2,4,9,12,0,Matches,Crystal Palace,2024
Jeffrey Schlupp,gh GHA,"MF,DF",32-144,1.1,2,0,1,0,1,0,3,0.0,3,6,0,6,0,2,2,0,Matches,Crystal Palace,2024
Romain Esse,eng ENG,MF,20-003,0.5,2,2,2,0,0,2,2,100.0,0,1,0,1,1,3,0,0,Matches,Crystal Palace,2024
Matheus França,br BRA,"FW,MF",21-045,0.3,1,0,0,1,0,0,0,,0,0,0,0,0,1,0,0,Matches,Crystal Palace,2024
Jordan Ayew,gh GHA,"FW,MF",33-247,0.2,1,0,0,0,1,0,0,,0,0,0,0,0,1,0,0,Matches,Crystal Palace,2024
Caleb Kporha,eng ENG,DF,18-305,0.1,2,1,2,0,0,2,2,100.0,0,0,0,0,0,2,1,0,Matches,Crystal Palace,2024
Asher Agbinone,eng ENG,MF,19-230,0.1,2,1,0,2,0,0,0,,0,0,0,0,0,2,0,0,Matches,Crystal Palace,2024
Joel Ward,eng ENG,DF,35-199,0.0,0,0,0,0,0,0,0,,0,0,0,0,0,0,0,0,Matches,Crystal Palace,2024
Jordan Pickford,eng ENG,GK,31-070,36.0,1,0,1,0,0,1,2,50.0,1,0,0,0,1,2,29,2,Matches,Everton,2024
James Tarkowski,eng ENG,DF,32-178,32.5,64,40,39,22,3,24,39,61.5,15,57,42,15,41,105,213,4,Matches,Everton,2024
Vitaliy Mykolenko,ua UKR,DF,25-352,32.2,55,33,33,14,8,26,52,50.0,26,25,10,15,39,94,137,2,Matches,Everton,2024
Idrissa Gana Gueye,sn SEN,MF,35-232,32.0,125,74,57,52,16,54,91,59.3,37,48,9,39,44,169,33,1,Matches,Everton,2024
Abdoulaye Doucouré,ml MLI,MF,32-135,27.6,46,27,21,18,7,13,41,31.7,28,31,6,25,9,55,19,1,Matches,Everton,2024
Jarrad Branthwaite,eng ENG,DF,22-323,27.1,36,20,26,10,0,20,27,74.1,7,31,23,8,25,61,190,4,Matches,Everton,2024
Iliman Ndiaye,sn SEN,FW,25-071,25.4,48,25,18,15,15,19,45,42.2,26,28,5,23,17,65,24,1,Matches,Everton,2024
Jack Harrison,eng ENG,FW,28-177,21.8,32,22,12,12,8,15,43,34.9,28,18,2,16,9,41,32,2,Matches,Everton,2024
Dominic Calvert-Lewin,eng ENG,FW,28-061,17.7,9,7,1,4,4,2,6,33.3,4,6,2,4,6,15,19,0,Matches,Everton,2024
Ashley Young,eng ENG,"DF,FW",39-311,19.0,53,30,23,23,7,32,53,60.4,21,13,4,9,24,77,64,1,Matches,Everton,2024
James Garner,eng ENG,"MF,DF",24-064,15.7,42,28,24,16,2,20,36,55.6,16,19,4,15,20,62,36,0,Matches,Everton,2024
Jake O'Brien,ie IRL,DF,24-001,15.5,24,16,19,5,0,16,24,66.7,8,16,4,12,4,28,80,0,Matches,Everton,2024
Jesper Lindstrøm,dk DEN,FW,25-076,13.8,45,25,24,19,2,19,55,34.5,36,15,3,12,12,57,17,0,Matches,Everton,2024
Dwight McNeil,eng ENG,"MF,FW",25-175,14.4,12,7,5,5,2,9,20,45.0,11,7,0,7,5,17,2,1,Matches,Everton,2024
Orel Mangala,be BEL,MF,27-059,14.0,16,8,3,11,2,5,8,62.5,3,8,3,5,21,37,24,1,Matches,Everton,2024
Beto,gw GNB,FW,27-105,15.1,14,6,2,8,4,5,8,62.5,3,10,1,9,3,17,21,1,Matches,Everton,2024
Michael Keane,eng ENG,DF,32-125,10.5,10,7,7,2,1,7,13,53.8,6,11,7,4,15,25,61,2,Matches,Everton,2024
Carlos Alcaraz,ar ARG,"FW,MF",22-167,7.4,11,5,5,3,3,3,9,33.3,6,7,1,6,4,15,10,0,Matches,Everton,2024
Tim Iroegbunam,eng ENG,MF,21-320,6.4,29,14,14,10,5,14,23,60.9,9,18,4,14,16,45,12,1,Matches,Everton,2024
Armando Broja,al ALB,FW,23-248,3.7,3,1,1,1,1,0,0,,0,3,0,3,1,4,4,0,Matches,Everton,2024
Nathan Patterson,sct SCO,DF,23-212,3.9,11,6,7,4,0,7,14,50.0,7,2,0,2,2,13,7,0,Matches,Everton,2024
Séamus Coleman,ie IRL,DF,36-217,2.2,3,2,2,1,0,3,4,75.0,1,5,3,2,1,4,8,0,Matches,Everton,2024
Roman Dixon,eng ENG,DF,20-141,1.0,5,5,3,2,0,4,4,100.0,0,1,0,1,1,6,3,0,Matches,Everton,2024
Harrison Armstrong,eng ENG,MF,18-117,0.5,0,0,0,0,0,0,1,0.0,1,0,0,0,0,0,1,0,Matches,Everton,2024
Youssef Chermiti,pt POR,"FW,MF",20-357,0.5,0,0,0,0,0,0,1,0.0,1,0,0,0,0,0,0,0,Matches,Everton,2024
Mason Holgate,eng ENG,"FW,DF",28-206,0.1,0,0,0,0,0,0,0,,0,0,0,0,0,0,0,0,Matches,Everton,2024
Bernd Leno,de GER,GK,33-073,36.0,2,2,2,0,0,2,2,100.0,0,1,0,1,0,2,10,5,Matches,Fulham,2024
Alex Iwobi,ng NGA,"FW,MF",29-013,32.1,42,24,13,21,8,21,32,65.6,11,25,1,24,13,55,28,0,Matches,Fulham,2024
Antonee Robinson,us USA,DF,27-281,33.2,90,57,53,30,7,44,89,49.4,45,37,7,30,57,147,124,2,Matches,Fulham,2024
Calvin Bassey,ng NGA,DF,25-136,33.2,53,33,34,19,0,21,30,70.0,9,39,17,22,19,72,111,8,Matches,Fulham,2024
Raúl Jiménez,mx MEX,FW,34-011,25.7,33,23,8,17,8,7,20,35.0,13,19,5,14,10,43,19,3,Matches,Fulham,2024
Joachim Andersen,dk DEN,DF,28-350,26.7,26,18,19,6,1,14,21,66.7,7,33,26,7,31,57,174,1,Matches,Fulham,2024
Saša Lukić,rs SRB,MF,28-276,24.1,66,37,21,39,6,21,53,39.6,32,19,7,12,26,92,32,0,Matches,Fulham,2024
Sander Berge,no NOR,MF,27-091,24.2,48,28,22,22,4,25,37,67.6,12,26,8,18,21,69,36,1,Matches,Fulham,2024
Andreas Pereira,br BRA,MF,29-135,21.7,23,13,7,11,5,10,41,24.4,31,16,2,14,8,31,17,3,Matches,Fulham,2024
Emile Smith Rowe,eng ENG,MF,24-292,21.6,31,18,7,14,10,8,24,33.3,16,21,2,19,11,42,16,0,Matches,Fulham,2024
Kenny Tete,nl NED,DF,29-219,17.7,50,34,24,14,12,20,34,58.8,14,25,8,17,29,79,53,0,Matches,Fulham,2024
Timothy Castagne,be BEL,DF,29-162,18.3,46,29,28,15,3,26,45,57.8,19,15,6,9,22,68,83,0,Matches,Fulham,2024
Adama Traoré,es ESP,"FW,MF",29-111,18.0,17,12,8,4,5,5,13,38.5,8,7,0,7,1,18,6,3,Matches,Fulham,2024
Issa Diop,fr FRA,DF,28-127,14.9,26,12,18,8,0,13,18,72.2,5,10,7,3,9,35,72,2,Matches,Fulham,2024
Harry Wilson,wls WAL,"FW,MF",28-055,12.0,16,11,10,3,3,9,15,60.0,6,13,1,12,5,21,7,1,Matches,Fulham,2024
Rodrigo Muniz,br BRA,FW,24-012,10.7,10,5,3,5,2,4,4,100.0,0,9,2,7,5,15,14,0,Matches,Fulham,2024
Ryan Sessegnon,eng ENG,"FW,DF",24-363,6.1,27,13,11,11,5,9,19,47.4,10,13,1,12,3,30,17,0,Matches,Fulham,2024
Reiss Nelson,eng ENG,FW,25-157,5.4,8,6,3,3,2,5,13,38.5,8,11,0,11,5,13,2,0,Matches,Fulham,2024
Jorge Cuenca,es ESP,DF,25-180,2.9,2,2,2,0,0,2,5,40.0,3,3,3,0,2,4,21,0,Matches,Fulham,2024
Tom Cairney,sct SCO,MF,34-116,5.7,11,5,4,2,5,4,7,57.1,3,5,1,4,4,15,1,1,Matches,Fulham,2024
Willian,br BRA,"FW,MF",36-280,2.9,4,2,0,3,1,2,6,33.3,4,0,0,0,1,5,1,0,Matches,Fulham,2024
Joshua King,eng ENG,MF,18-133,1.0,5,3,2,3,0,0,2,0.0,2,2,0,2,1,6,1,0,Matches,Fulham,2024
Harrison Reed,eng ENG,MF,30-109,1.2,6,3,3,2,1,1,3,33.3,2,1,0,1,1,7,3,0,Matches,Fulham,2024
Martial Godo,eng ENG,"FW,DF",22-063,0.3,0,0,0,0,0,0,0,,0,1,0,1,1,1,0,0,Matches,Fulham,2024
Carlos Vinícius,br BRA,"MF,FW",30-052,0.2,0,0,0,0,0,0,1,0.0,1,1,0,1,0,0,0,0,Matches,Fulham,2024
Jay Stansfield,eng ENG,MF,22-173,0.0,0,0,0,0,0,0,0,,0,0,0,0,0,0,0,0,Matches,Fulham,2024
Dara O'Shea,ie IRL,DF,26-073,32.7,47,30,33,11,3,20,31,64.5,11,61,49,12,31,78,211,4,Matches,Ipswich Town,2024
Liam Delap,eng ENG,FW,22-097,28.4,11,8,3,3,5,2,14,14.3,12,8,0,8,2,13,28,0,Matches,Ipswich Town,2024
Leif Davis,eng ENG,DF,25-124,28.5,45,26,32,9,4,29,46,63.0,17,24,8,16,25,70,72,3,Matches,Ipswich Town,2024
Sam Morsy,eg EGY,MF,33-248,28.6,65,38,38,23,4,26,58,44.8,32,32,13,19,29,94,44,4,Matches,Ipswich Town,2024
Omari Hutchinson,eng ENG,"MF,FW",21-198,26.7,31,12,14,10,7,13,47,27.7,34,25,1,24,10,41,13,1,Matches,Ipswich Town,2024
Jacob Greaves,eng ENG,DF,24-246,22.5,38,20,20,17,1,21,33,63.6,12,38,25,13,19,57,133,3,Matches,Ipswich Town,2024
Jens Cajuste,se SWE,MF,25-279,20.1,42,20,19,22,1,21,49,42.9,28,24,9,15,25,67,33,2,Matches,Ipswich Town,2024
Arijanet Muric,xk KVX,GK,26-190,18.0,0,0,0,0,0,0,2,0.0,2,0,0,0,0,0,10,5,Matches,Ipswich Town,2024
Axel Tuanzebe,cd COD,DF,27-183,17.0,29,17,20,3,6,16,24,66.7,8,18,9,9,22,51,54,1,Matches,Ipswich Town,2024
Cameron Burgess,au AUS,DF,29-207,17.1,17,12,14,3,0,9,11,81.8,2,20,15,5,14,31,128,3,Matches,Ipswich Town,2024
Ben Johnson,eng ENG,"DF,FW",25-112,15.0,38,22,23,12,3,20,41,48.8,21,22,5,17,13,51,54,1,Matches,Ipswich Town,2024
Kalvin Phillips,eng ENG,MF,29-165,13.7,35,19,8,20,7,15,39,38.5,24,35,6,29,19,54,37,2,Matches,Ipswich Town,2024
Sammie Szmodics,ie IRL,"FW,MF",29-234,10.9,15,9,4,9,2,6,23,26.1,17,10,2,8,6,21,14,0,Matches,Ipswich Town,2024
Luke Woolfenden,eng ENG,DF,26-207,13.2,9,6,5,4,0,2,5,40.0,3,21,14,7,19,28,76,0,Matches,Ipswich Town,2024
Alex Palmer,eng ENG,GK,28-279,12.0,0,0,0,0,0,0,0,,0,0,0,0,0,0,12,0,Matches,Ipswich Town,2024
Wes Burns,wls WAL,"FW,DF",30-174,10.3,13,11,1,9,3,4,10,40.0,6,7,2,5,10,23,13,2,Matches,Ipswich Town,2024
Jack Clarke,eng ENG,"FW,MF",24-174,12.1,28,17,11,9,8,16,32,50.0,16,6,0,6,7,35,29,1,Matches,Ipswich Town,2024
Julio Enciso,py PAR,"FW,MF",21-113,8.9,12,9,3,6,3,4,11,36.4,7,5,1,4,1,13,6,0,Matches,Ipswich Town,2024
Conor Chaplin,eng ENG,"MF,FW",28-089,8.5,12,5,4,6,2,6,13,46.2,7,8,1,7,3,15,3,0,Matches,Ipswich Town,2024
Nathan Broadhead,wls WAL,"MF,FW",27-041,6.7,7,3,2,5,0,3,9,33.3,6,6,1,5,4,11,5,0,Matches,Ipswich Town,2024
Christian Walton,eng ENG,GK,29-188,6.0,0,0,0,0,0,0,1,0.0,1,0,0,0,0,0,1,1,Matches,Ipswich Town,2024
Jaden Philogene Bidace,eng ENG,"FW,DF",23-097,5.3,14,7,6,6,2,8,15,53.3,7,11,1,10,10,24,9,1,Matches,Ipswich Town,2024
Jack Taylor,ie IRL,MF,26-327,9.2,20,10,6,11,3,12,25,48.0,13,10,3,7,9,29,24,0,Matches,Ipswich Town,2024
Harry Clarke,eng ENG,DF,24-075,4.2,5,3,3,2,0,3,6,50.0,3,5,4,1,4,9,14,3,Matches,Ipswich Town,2024
George Hirst,sct SCO,FW,26-090,5.8,3,3,1,0,2,1,3,33.3,2,1,1,0,2,5,10,0,Matches,Ipswich Town,2024
Conor Townsend,eng ENG,DF,32-073,3.7,11,8,9,2,0,8,11,72.7,3,8,6,2,4,15,16,0,Matches,Ipswich Town,2024
Chiedozie Ogbene,ie IRL,FW,28-015,2.6,7,3,1,2,4,2,4,50.0,2,1,0,1,1,8,3,0,Matches,Ipswich Town,2024
Massimo Luongo,au AUS,MF,32-233,2.2,8,5,6,1,1,4,7,57.1,3,4,2,2,2,10,2,0,Matches,Ipswich Town,2024
Ben Godfrey,eng ENG,DF,27-121,1.8,1,0,1,0,0,1,1,100.0,0,1,1,0,2,3,3,0,Matches,Ipswich Town,2024
Ali Al Hamadi,iq IRQ,FW,23-076,1.5,1,0,0,0,1,0,2,0.0,2,0,0,0,0,1,2,0,Matches,Ipswich Town,2024
Marcus Harness,eng ENG,MF,29-081,0.5,1,0,0,0,1,0,3,0.0,3,2,1,1,0,1,1,0,Matches,Ipswich Town,2024
George Edmundson,eng ENG,DF,27-258,0.0,0,0,0,0,0,0,0,,0,0,0,0,0,0,0,0,Matches,Ipswich Town,2024
Jamie Vardy,eng ENG,FW,38-125,30.5,19,13,7,7,5,4,13,30.8,9,8,4,4,5,24,23,0,Matches,Leicester City,2024
James Justin,eng ENG,DF,27-082,30.7,50,30,25,20,5,28,51,54.9,23,43,14,29,45,95,132,3,Matches,Leicester City,2024
Wout Faes,be BEL,DF,27-043,29.3,39,23,25,12,2,23,43,53.5,20,45,33,12,26,65,173,4,Matches,Leicester City,2024
Victor Bernth Kristiansen,dk DEN,DF,22-151,26.6,85,50,54,26,5,47,87,54.0,40,37,14,23,40,125,72,3,Matches,Leicester City,2024
Mads Hermansen,dk DEN,GK,24-309,26.5,1,1,1,0,0,1,1,100.0,0,1,0,1,0,1,13,4,Matches,Leicester City,2024
Wilfred Ndidi,ng NGA,MF,28-151,24.9,81,50,45,29,7,27,54,50.0,27,47,19,28,29,110,78,0,Matches,Leicester City,2024
Bilal El Khannouss,ma MAR,MF,21-006,23.2,47,27,15,27,5,15,29,51.7,14,22,4,18,6,53,10,3,Matches,Leicester City,2024
Boubakary Soumaré,fr FRA,MF,26-078,22.1,33,18,21,11,1,18,30,60.0,12,22,10,12,25,58,31,3,Matches,Leicester City,2024
Harry Winks,eng ENG,MF,29-103,17.1,24,11,12,10,2,13,30,43.3,17,19,7,12,9,33,20,0,Matches,Leicester City,2024
Conor Coady,eng ENG,DF,32-080,17.0,12,8,6,5,1,3,6,50.0,3,28,20,8,13,25,67,2,Matches,Leicester City,2024
Jordan Ayew,gh GHA,"FW,MF",33-247,16.5,26,14,7,14,5,6,19,31.6,13,19,1,18,12,38,17,0,Matches,Leicester City,2024
Stephy Mavididi,eng ENG,FW,26-350,17.9,34,19,16,10,8,14,42,33.3,28,26,2,24,11,45,15,0,Matches,Leicester City,2024
Jannik Vestergaard,dk DEN,DF,32-286,15.5,22,10,16,6,0,9,15,60.0,6,21,14,7,16,38,74,1,Matches,Leicester City,2024
Facundo Buonanotte,ar ARG,"FW,MF",20-144,16.7,53,32,17,22,14,21,67,31.3,46,33,6,27,12,65,14,0,Matches,Leicester City,2024
Caleb Okoli,it ITA,DF,23-307,12.5,25,14,8,15,2,11,18,61.1,7,24,14,10,15,40,79,3,Matches,Leicester City,2024
Luke Thomas,eng ENG,DF,23-340,10.5,27,21,21,4,2,19,35,54.3,16,13,5,8,18,45,41,1,Matches,Leicester City,2024
Oliver Skipp,eng ENG,MF,24-242,11.7,20,4,5,12,3,9,15,60.0,6,19,6,13,10,30,11,2,Matches,Leicester City,2024
Bobby De Cordova-Reid,jm JAM,FW,32-103,8.3,9,4,3,6,0,4,14,28.6,10,6,1,5,0,9,10,0,Matches,Leicester City,2024
Jakub Stolarczyk,pl POL,GK,24-148,8.0,2,1,2,0,0,1,2,50.0,1,0,0,0,0,2,6,0,Matches,Leicester City,2024
Kasey McAteer,ie IRL,"FW,MF",23-175,7.6,18,14,10,5,3,10,23,43.5,13,15,1,14,3,21,15,0,Matches,Leicester City,2024
Abdul Fatawu Issahaku,gh GHA,FW,21-069,6.4,21,15,13,2,6,11,19,57.9,8,7,0,7,4,25,12,0,Matches,Leicester City,2024
Patson Daka,zm ZAM,"FW,MF",26-219,7.3,17,9,4,9,4,7,17,41.2,10,7,1,6,1,18,10,0,Matches,Leicester City,2024
Ricardo Pereira,pt POR,DF,31-222,3.8,11,6,4,4,3,6,12,50.0,6,6,2,4,2,13,10,0,Matches,Leicester City,2024
Danny Ward,wls WAL,GK,31-328,1.5,0,0,0,0,0,0,0,,0,0,0,0,0,0,1,0,Matches,Leicester City,2024
Hamza Choudhury,bd BAN,"MF,DF",27-227,1.5,1,1,1,0,0,1,3,33.3,2,4,2,2,5,6,2,0,Matches,Leicester City,2024
Woyo Coulibaly,fr FRA,DF,25-361,1.2,6,4,4,2,0,2,2,100.0,0,3,1,2,5,11,1,0,Matches,Leicester City,2024
Jeremy Monga,,"FW,MF",,0.7,1,1,0,1,0,1,1,100.0,0,3,2,1,0,1,1,0,Matches,Leicester City,2024
Odsonne Édouard,fr FRA,FW,27-120,0.3,1,1,1,0,0,0,0,,0,0,0,0,0,1,1,0,Matches,Leicester City,2024
Jake Evans,,FW,,0.1,0,0,0,0,0,0,1,0.0,1,0,0,0,0,0,1,0,Matches,Leicester City,2024
Will Alves,eng ENG,FW,20-102,0.0,0,0,0,0,0,0,0,,0,0,0,0,0,0,0,0,Matches,Leicester City,2024
Michael Golding,eng ENG,MF,18-358,0.0,0,0,0,0,0,0,0,,0,0,0,0,0,0,0,0,Matches,Leicester City,2024
Virgil van Dijk,nl NED,DF,33-312,36.0,35,17,17,16,2,11,20,55.0,9,27,16,11,54,89,184,4,Matches,Liverpool,2024
Mohamed Salah,eg EGY,FW,32-335,35.5,21,11,7,5,9,8,17,47.1,9,11,0,11,7,28,5,0,Matches,Liverpool,2024
Ryan Gravenberch,nl NED,MF,23-000,33.4,67,35,27,29,11,32,54,59.3,22,35,10,25,57,124,57,2,Matches,Liverpool,2024
Alexis Mac Allister,ar ARG,MF,26-143,28.9,95,58,28,51,16,55,104,52.9,49,61,6,55,22,117,29,1,Matches,Liverpool,2024
Ibrahima Konaté,fr FRA,DF,25-356,26.8,38,26,25,11,2,24,34,70.6,10,28,15,13,12,50,128,2,Matches,Liverpool,2024
Andrew Robertson,sct SCO,DF,31-066,26.6,39,22,25,10,4,31,50,62.0,19,10,4,6,21,60,53,2,Matches,Liverpool,2024
Trent Alexander-Arnold,eng ENG,DF,26-221,25.8,71,50,43,19,9,48,103,46.6,55,26,9,17,31,102,54,4,Matches,Liverpool,2024
Dominik Szoboszlai,hu HUN,MF,24-203,26.3,33,20,12,16,5,15,39,38.5,24,37,4,33,9,42,19,2,Matches,Liverpool,2024
Luis Díaz,co COL,FW,28-123,25.6,35,23,11,18,6,13,37,35.1,24,19,0,19,7,42,7,1,Matches,Liverpool,2024
Alisson,br BRA,GK,32-226,25.9,1,0,1,0,0,0,1,0.0,1,0,0,0,0,1,13,1,Matches,Liverpool,2024
Cody Gakpo,nl NED,FW,26-009,19.8,27,15,5,13,9,12,24,50.0,12,21,2,19,11,38,16,1,Matches,Liverpool,2024
Curtis Jones,eng ENG,"MF,DF",24-106,17.7,37,21,6,22,9,17,26,65.4,9,19,9,10,7,44,8,3,Matches,Liverpool,2024
Diogo Jota,pt POR,FW,28-163,13.0,14,8,2,8,4,7,19,36.8,12,9,0,9,7,21,6,0,Matches,Liverpool,2024
Caoimhín Kelleher,ie IRL,GK,26-174,10.0,0,0,0,0,0,0,0,,0,0,0,0,0,0,1,2,Matches,Liverpool,2024
Darwin Núñez,uy URU,FW,25-326,11.9,20,17,11,3,6,6,16,37.5,10,6,0,6,3,23,12,0,Matches,Liverpool,2024
Kostas Tsimikas,gr GRE,DF,29-004,8.3,29,18,13,11,5,13,20,65.0,7,5,2,3,10,39,20,0,Matches,Liverpool,2024
Joe Gomez,eng ENG,DF,27-358,5.8,13,10,5,7,1,11,16,68.8,5,9,6,3,7,20,20,2,Matches,Liverpool,2024
Conor Bradley,nir NIR,DF,21-311,7.0,13,10,7,4,2,10,20,50.0,10,5,0,5,4,17,25,0,Matches,Liverpool,2024
Jarell Quansah,eng ENG,DF,22-107,4.5,11,8,8,3,0,6,8,75.0,2,8,7,1,6,17,18,1,Matches,Liverpool,2024
Harvey Elliott,eng ENG,"MF,FW",22-042,3.1,4,3,2,1,1,1,5,20.0,4,5,1,4,1,5,2,1,Matches,Liverpool,2024
Wataru Endo,jp JPN,MF,32-096,2.6,11,8,6,5,0,6,10,60.0,4,7,1,6,3,14,7,0,Matches,Liverpool,2024
Federico Chiesa,it ITA,FW,27-203,0.5,0,0,0,0,0,0,2,0.0,2,1,0,1,0,0,0,1,Matches,Liverpool,2024
Vitezslav Jaros,cz CZE,GK,23-297,0.1,0,0,0,0,0,0,0,,0,0,0,0,0,0,0,0,Matches,Liverpool,2024
Jayden Danns,eng ENG,MF,19-120,0.1,0,0,0,0,0,0,1,0.0,1,0,0,0,0,0,0,0,Matches,Liverpool,2024
Joško Gvardiol,hr CRO,DF,23-113,34.4,54,36,24,19,11,20,38,52.6,18,41,20,21,39,93,117,8,Matches,Manchester City,2024
Erling Haaland,no NOR,FW,24-299,28.6,10,5,3,3,4,2,6,33.3,4,11,1,10,5,15,23,0,Matches,Manchester City,2024
Bernardo Silva,pt POR,"MF,FW",30-279,27.7,53,35,15,29,9,24,52,46.2,28,33,7,26,20,73,29,3,Matches,Manchester City,2024
Ederson,br BRA,GK,31-272,23.8,0,0,0,0,0,0,2,0.0,2,0,0,0,1,1,9,2,Matches,Manchester City,2024
Mateo Kovačić,hr CRO,MF,31-010,23.7,68,38,22,38,8,31,65,47.7,34,20,0,20,22,90,20,1,Matches,Manchester City,2024
Rúben Dias,pt POR,DF,28-002,23.2,16,10,6,9,1,7,11,63.6,4,19,16,3,18,34,61,3,Matches,Manchester City,2024
İlkay Gündoğan,de GER,MF,34-204,22.8,24,13,4,15,5,10,23,43.5,13,14,0,14,13,37,22,0,Matches,Manchester City,2024
Rico Lewis,eng ENG,"DF,MF",20-176,21.0,30,19,13,12,5,13,21,61.9,8,28,7,21,13,43,45,1,Matches,Manchester City,2024
Manuel Akanji,ch SUI,DF,29-301,20.4,17,11,10,4,3,9,15,60.0,6,11,8,3,7,24,61,3,Matches,Manchester City,2024
Sávio,br BRA,"FW,MF",21-036,19.4,23,17,5,10,8,10,19,52.6,9,14,2,12,6,29,9,1,Matches,Manchester City,2024
Phil Foden,eng ENG,"MF,FW",24-353,19.6,12,5,5,4,3,7,18,38.9,11,13,1,12,9,21,7,1,Matches,Manchester City,2024
Kevin De Bruyne,be BEL,"MF,FW",33-322,18.1,17,9,7,5,5,5,23,21.7,18,8,0,8,7,24,10,1,Matches,Manchester City,2024
Matheus Nunes,pt POR,"DF,MF",26-262,16.6,32,21,13,13,6,15,34,44.1,19,14,3,11,13,45,35,1,Matches,Manchester City,2024
Jeremy Doku,be BEL,"FW,MF",22-354,16.0,30,21,9,12,9,8,15,53.3,7,10,1,9,4,34,2,0,Matches,Manchester City,2024
Stefan Ortega,de GER,GK,32-191,12.2,0,0,0,0,0,0,1,0.0,1,0,0,0,0,0,11,1,Matches,Manchester City,2024
Omar Marmoush,eg EGY,"FW,MF",26-098,11.2,11,6,2,7,2,7,15,46.7,8,15,1,14,5,16,3,0,Matches,Manchester City,2024
Kyle Walker,eng ENG,DF,34-353,10.8,17,10,7,7,3,14,26,53.8,12,13,4,9,3,20,13,1,Matches,Manchester City,2024
Nathan Aké,nl NED,DF,30-087,7.5,9,7,7,2,0,4,6,66.7,2,7,2,5,3,12,22,1,Matches,Manchester City,2024
Nicolás González,es ESP,MF,23-133,7.2,15,6,5,6,4,6,11,54.5,5,9,0,9,5,20,17,0,Matches,Manchester City,2024
Jack Grealish,eng ENG,"FW,MF",29-248,8.0,9,5,4,2,3,2,5,40.0,3,12,2,10,2,11,5,1,Matches,Manchester City,2024
John Stones,eng ENG,"DF,MF",30-353,6.1,6,2,3,2,1,5,5,100.0,0,5,3,2,4,10,19,1,Matches,Manchester City,2024
Nico O’Reilly,eng ENG,DF,20-056,5.9,9,4,3,3,3,4,8,50.0,4,5,1,4,4,13,12,0,Matches,Manchester City,2024
Abdukodir Khusanov,uz UZB,DF,21-076,5.6,5,4,4,1,0,2,3,66.7,1,5,4,1,3,8,29,1,Matches,Manchester City,2024
James Mcatee,eng ENG,"MF,FW",22-210,3.9,5,2,0,4,1,1,7,14.3,6,8,0,8,2,7,1,0,Matches,Manchester City,2024
Jahmai Simpson-Pusey,eng ENG,DF,19-193,1.1,1,0,1,0,0,0,1,0.0,1,1,1,0,0,1,2,0,Matches,Manchester City,2024
Rodri,es ESP,MF,28-328,0.7,2,1,1,1,0,0,0,,0,1,0,1,1,3,0,0,Matches,Manchester City,2024
Divin Mubama,eng ENG,FW,20-203,0.3,0,0,0,0,0,0,0,,0,0,0,0,0,0,0,0,Matches,Manchester City,2024
Oscar Bobb,no NOR,FW,21-308,0.2,0,0,0,0,0,0,0,,0,0,0,0,0,0,0,0,Matches,Manchester City,2024
Vitor Reis,br BRA,DF,19-124,0.0,0,0,0,0,0,0,0,,0,0,0,0,0,0,1,0,Matches,Manchester City,2024
André Onana,cm CMR,GK,29-044,33.0,1,1,1,0,0,1,3,33.3,2,0,0,0,0,1,11,4,Matches,Manchester United,2024
Bruno Fernandes,pt POR,MF,30-250,31.6,77,47,25,37,15,30,78,38.5,48,33,5,28,25,102,35,2,Matches,Manchester United,2024
Noussair Mazraoui,ma MAR,DF,27-183,30.3,109,63,55,40,14,55,89,61.8,34,33,8,25,34,143,91,1,Matches,Manchester United,2024
Diogo Dalot,pt POR,DF,26-059,31.0,67,39,39,22,6,34,52,65.4,18,22,9,13,37,104,72,0,Matches,Manchester United,2024
Matthijs de Ligt,nl NED,DF,25-277,23.6,30,22,17,12,1,23,32,71.9,9,29,21,8,33,63,96,0,Matches,Manchester United,2024
Alejandro Garnacho,ar ARG,"MF,FW",20-319,24.2,29,18,10,6,13,12,36,33.3,24,19,0,19,13,42,11,2,Matches,Manchester United,2024
Manuel Ugarte Ribeiro,uy URU,MF,24-035,19.6,75,47,32,34,9,29,67,43.3,38,32,4,28,27,102,17,2,Matches,Manchester United,2024
Rasmus Højlund,dk DEN,FW,22-101,20.4,3,1,0,2,1,0,4,0.0,4,5,0,5,1,4,6,0,Matches,Manchester United,2024
Lisandro Martínez,ar ARG,DF,27-118,19.5,40,24,25,12,3,21,36,58.3,15,22,8,14,32,72,57,1,Matches,Manchester United,2024
Kobbie Mainoo,eng ENG,MF,20-027,17.7,44,27,17,14,13,23,38,60.5,15,16,2,14,19,63,13,1,Matches,Manchester United,2024
Amad Diallo,ci CIV,"FW,MF",22-309,19.1,36,29,7,20,9,18,30,60.0,12,12,0,12,11,47,17,0,Matches,Manchester United,2024
Harry Maguire,eng ENG,DF,32-072,17.5,27,14,21,5,1,14,20,70.0,6,15,12,3,39,66,73,1,Matches,Manchester United,2024
Casemiro,br BRA,MF,33-082,14.8,77,46,45,23,9,41,66,62.1,25,33,10,23,12,89,48,3,Matches,Manchester United,2024
Joshua Zirkzee,nl NED,"FW,MF",23-359,15.6,14,8,3,8,3,5,10,50.0,5,15,4,11,6,20,8,1,Matches,Manchester United,2024
Leny Yoro,fr FRA,DF,19-184,12.9,29,11,19,9,1,13,19,68.4,6,5,3,2,18,47,43,0,Matches,Manchester United,2024
Marcus Rashford,eng ENG,"FW,MF",27-197,10.9,7,4,2,2,3,3,9,33.3,6,8,0,8,4,11,7,0,Matches,Manchester United,2024
Christian Eriksen,dk DEN,MF,33-091,11.5,19,9,4,12,3,11,26,42.3,15,14,4,10,7,26,7,0,Matches,Manchester United,2024
Patrick Dorgu,dk DEN,DF,20-202,7.4,25,19,12,11,2,14,19,73.7,5,10,0,10,4,29,19,2,Matches,Manchester United,2024
Mason Mount,eng ENG,MF,26-126,5.4,12,4,5,7,0,8,10,80.0,2,9,1,8,3,15,3,0,Matches,Manchester United,2024
Victor Lindelöf,se SWE,DF,30-303,5.8,6,2,5,0,1,3,4,75.0,1,5,3,2,7,13,33,2,Matches,Manchester United,2024
Harry Amass,eng ENG,DF,18-061,3.8,6,2,5,1,0,2,8,25.0,6,11,1,10,2,8,11,0,Matches,Manchester United,2024
Jonny Evans,nir NIR,DF,37-133,3.2,7,5,4,3,0,2,4,50.0,2,2,1,1,4,11,13,0,Matches,Manchester United,2024
Altay Bayındır,tr TUR,GK,27-032,3.0,0,0,0,0,0,0,1,0.0,1,0,0,0,0,0,6,1,Matches,Manchester United,2024
Luke Shaw,eng ENG,DF,29-308,3.0,4,3,2,2,0,2,2,100.0,0,5,1,4,2,6,7,0,Matches,Manchester United,2024
Tyler Fredricson,eng ENG,DF,20-082,1.8,5,3,3,2,0,1,2,50.0,1,2,0,2,1,6,11,0,Matches,Manchester United,2024
Tyrell Malacia,nl NED,DF,25-272,1.1,2,1,2,0,0,1,2,50.0,1,0,0,0,1,3,1,1,Matches,Manchester United,2024
Chidozie Obi-Martin,dk DEN,FW,17-168,1.7,2,1,0,0,2,2,2,100.0,0,0,0,0,0,2,1,0,Matches,Manchester United,2024
Ayden Heaven,eng ENG,DF,18-236,1.1,3,3,1,2,0,2,2,100.0,0,2,2,0,1,4,6,0,Matches,Manchester United,2024
Toby Collyer,eng ENG,MF,21-133,2.0,12,9,6,6,0,5,6,83.3,1,2,1,1,2,14,3,0,Matches,Manchester United,2024
Antony,br BRA,"DF,MF",25-081,1.6,6,3,4,2,0,2,5,40.0,3,2,0,2,2,8,0,0,Matches,Manchester United,2024
Scott McTominay,sct SCO,MF,28-159,0.2,0,0,0,0,0,0,1,0.0,1,0,0,0,0,0,1,0,Matches,Manchester United,2024
Bruno Guimarães,br BRA,MF,27-181,34.3,76,43,37,28,11,32,67,47.8,35,35,10,25,28,104,42,4,Matches,Newcastle United,2024
Dan Burn,eng ENG,DF,33-007,35.0,35,20,20,13,2,17,33,51.5,16,34,24,10,26,61,184,3,Matches,Newcastle United,2024
Alexander Isak,se SWE,FW,25-237,29.6,12,5,2,3,7,5,15,33.3,10,18,2,16,3,15,17,1,Matches,Newcastle United,2024
Fabian Schär,ch SUI,DF,33-147,30.6,34,21,15,17,2,14,34,41.2,20,37,24,13,41,75,125,3,Matches,Newcastle United,2024
Valentino Livramento,eng ENG,DF,22-185,29.6,54,36,35,15,4,32,59,54.2,27,35,10,25,21,75,103,1,Matches,Newcastle United,2024
Joelinton,br BRA,"MF,FW",28-275,26.6,57,35,23,23,11,25,44,56.8,19,37,7,30,23,80,47,2,Matches,Newcastle United,2024
Jacob Murphy,eng ENG,FW,30-081,24.8,24,16,8,10,6,18,35,51.4,17,31,0,31,12,36,31,1,Matches,Newcastle United,2024
Sandro Tonali,it ITA,MF,25-008,27.2,48,30,21,22,5,23,46,50.0,23,32,10,22,33,81,33,2,Matches,Newcastle United,2024
Nick Pope,eng ENG,GK,33-027,26.0,0,0,0,0,0,0,0,,0,1,0,1,1,1,30,5,Matches,Newcastle United,2024
Anthony Gordon,eng ENG,FW,24-081,25.5,31,17,9,18,4,12,34,35.3,22,24,2,22,6,37,9,2,Matches,Newcastle United,2024
Lewis Hall,eng ENG,DF,20-250,24.3,58,41,28,22,8,40,74,54.1,34,33,18,15,18,76,75,3,Matches,Newcastle United,2024
Harvey Barnes,eng ENG,FW,27-158,17.7,16,9,4,6,6,3,11,27.3,8,7,1,6,6,22,14,1,Matches,Newcastle United,2024
Kieran Trippier,eng ENG,DF,34-239,14.2,37,20,18,13,6,21,35,60.0,14,11,3,8,12,49,49,0,Matches,Newcastle United,2024
Joe Willock,eng ENG,"MF,FW",25-269,11.4,28,16,15,10,3,18,29,62.1,11,24,6,18,6,34,7,0,Matches,Newcastle United,2024
Martin Dúbravka,sk SVK,GK,36-121,10.0,0,0,0,0,0,0,0,,0,0,0,0,0,0,3,0,Matches,Newcastle United,2024
Sean Longstaff,eng ENG,MF,27-198,8.9,27,16,10,9,8,18,27,66.7,9,17,5,12,7,34,8,0,Matches,Newcastle United,2024
Lloyd Kelly,eng ENG,DF,26-222,3.4,5,4,4,1,0,1,1,100.0,0,6,4,2,1,6,17,0,Matches,Newcastle United,2024
Sven Botman,nl NED,DF,25-124,3.2,8,6,4,4,0,4,6,66.7,2,4,3,1,5,13,19,0,Matches,Newcastle United,2024
Emil Krafth,se SWE,DF,30-287,3.5,4,2,2,1,1,2,3,66.7,1,5,4,1,2,6,14,0,Matches,Newcastle United,2024
Callum Wilson,eng ENG,FW,33-078,3.2,2,2,0,1,1,0,2,0.0,2,2,0,2,1,3,1,0,Matches,Newcastle United,2024
Lewis Miley,eng ENG,MF,19-015,3.2,12,10,4,7,1,7,14,50.0,7,5,1,4,2,14,5,2,Matches,Newcastle United,2024
Miguel Almirón,py PAR,FW,31-095,1.7,3,2,2,0,1,2,3,66.7,1,2,0,2,0,3,0,0,Matches,Newcastle United,2024
William Osula,dk DEN,FW,21-285,1.2,1,0,0,0,1,0,2,0.0,2,0,0,0,4,5,2,0,Matches,Newcastle United,2024
Matt Targett,eng ENG,DF,29-240,0.2,0,0,0,0,0,0,1,0.0,1,0,0,0,1,1,1,0,Matches,Newcastle United,2024
Matz Sels,be BEL,GK,33-079,36.0,1,1,1,0,0,1,1,100.0,0,0,0,0,0,1,25,1,Matches,Nottingham Forest,2024
Nikola Milenković,rs SRB,DF,27-216,35.0,44,27,31,11,2,22,28,78.6,6,40,24,16,25,69,196,1,Matches,Nottingham Forest,2024
Murillo,br BRA,DF,22-316,33.4,53,36,38,12,3,27,46,58.7,19,67,44,23,32,85,236,3,Matches,Nottingham Forest,2024
Ola Aina,ng NGA,DF,28-220,31.4,54,41,39,14,1,35,63,55.6,28,32,12,20,31,85,107,4,Matches,Nottingham Forest,2024
Chris Wood,nz NZL,FW,33-160,30.9,5,4,1,2,2,2,9,22.2,7,12,7,5,5,10,27,1,Matches,Nottingham Forest,2024
Morgan Gibbs-White,eng ENG,MF,25-109,29.2,42,21,14,22,6,16,32,50.0,16,17,4,13,21,63,28,1,Matches,Nottingham Forest,2024
Elliot Anderson,eng ENG,MF,22-191,28.4,86,52,51,28,7,44,103,42.7,59,44,9,35,30,116,70,4,Matches,Nottingham Forest,2024
Anthony Elanga,se SWE,"FW,MF",23-019,25.8,18,13,8,8,2,5,17,29.4,12,11,1,10,6,24,25,0,Matches,Nottingham Forest,2024
Neco Williams,wls WAL,DF,24-033,26.8,79,48,57,16,6,45,75,60.0,30,40,9,31,25,104,129,2,Matches,Nottingham Forest,2024
Callum Hudson-Odoi,eng ENG,"FW,MF",24-190,23.9,20,14,7,8,5,11,17,64.7,6,11,0,11,13,33,11,1,Matches,Nottingham Forest,2024
Nicolás Domínguez,ar ARG,"MF,FW",26-322,20.1,78,40,35,32,11,30,67,44.8,37,37,11,26,29,107,49,1,Matches,Nottingham Forest,2024
Ryan Yates,eng ENG,MF,27-176,21.0,42,21,24,14,4,17,37,45.9,20,36,9,27,26,68,61,1,Matches,Nottingham Forest,2024
Álex Moreno,es ESP,"DF,MF",31-342,10.6,25,18,20,5,0,15,39,38.5,24,11,5,6,15,40,43,0,Matches,Nottingham Forest,2024
Morato,br BRA,DF,23-320,10.0,21,13,18,2,1,13,21,61.9,8,12,4,8,10,31,77,2,Matches,Nottingham Forest,2024
Jota Silva,pt POR,"FW,MF",25-288,9.4,25,13,12,11,2,5,25,20.0,20,9,1,8,12,37,17,0,Matches,Nottingham Forest,2024
Ibrahim Sangaré,ci CIV,MF,27-165,5.0,24,13,6,15,3,6,14,42.9,8,8,3,5,4,28,7,1,Matches,Nottingham Forest,2024
James Ward-Prowse,eng ENG,MF,30-196,4.4,4,1,1,3,0,2,2,100.0,0,3,2,1,5,9,8,0,Matches,Nottingham Forest,2024
Danilo,br BRA,"MF,FW",24-017,3.0,6,3,5,1,0,2,4,50.0,2,2,1,1,3,9,3,0,Matches,Nottingham Forest,2024
Taiwo Awoniyi,ng NGA,FW,27-277,4.6,6,3,0,3,3,4,5,80.0,1,1,0,1,0,6,7,0,Matches,Nottingham Forest,2024
Ramón Sosa,py PAR,"FW,MF",25-258,3.3,5,3,3,0,2,1,5,20.0,4,9,0,9,4,9,5,0,Matches,Nottingham Forest,2024
Willy Boly,ci CIV,DF,34-102,1.7,6,1,5,1,0,4,4,100.0,0,4,2,2,3,9,12,0,Matches,Nottingham Forest,2024
Harry Toffolo,eng ENG,DF,29-270,1.5,5,3,3,1,1,3,4,75.0,1,2,2,0,2,7,12,0,Matches,Nottingham Forest,2024
Eric da Silva Moreira,de GER,"MF,DF",19-013,0.3,2,2,2,0,0,2,6,33.3,4,0,0,0,1,3,0,0,Matches,Nottingham Forest,2024
Kyle Walker-Peters,eng ENG,DF,28-033,32.4,44,29,22,15,7,16,35,45.7,19,27,15,12,19,63,90,1,Matches,Southampton,2024
Mateus Fernandes,pt POR,MF,20-310,30.3,86,46,43,28,15,33,66,50.0,33,41,7,34,26,112,34,7,Matches,Southampton,2024
Taylor Harwood-Bellis,eng ENG,DF,23-106,30.5,27,19,13,11,3,19,35,54.3,16,62,40,22,30,57,137,6,Matches,Southampton,2024
Jan Bednarek,pl POL,DF,29-034,28.1,36,19,23,13,0,16,31,51.6,15,47,36,11,56,92,190,5,Matches,Southampton,2024
Aaron Ramsdale,eng ENG,GK,27-002,28.0,0,0,0,0,0,0,2,0.0,2,0,0,0,2,2,9,2,Matches,Southampton,2024
Flynn Downes,eng ENG,MF,26-116,21.9,46,24,21,20,5,15,35,42.9,20,24,6,18,31,77,46,4,Matches,Southampton,2024
Joe Aribo,ng NGA,"MF,DF",28-299,21.7,47,33,17,24,6,17,35,48.6,18,26,10,16,20,67,32,3,Matches,Southampton,2024
Tyler Dibling,eng ENG,"FW,MF",19-065,20.1,34,20,13,18,3,16,26,61.5,10,19,5,14,8,42,16,1,Matches,Southampton,2024
Ryan Manning,ie IRL,"DF,MF",28-336,16.2,28,17,16,10,2,14,26,53.8,12,20,11,9,17,45,47,0,Matches,Southampton,2024
Lesley Ugochukwu,fr FRA,MF,21-051,17.4,49,24,15,30,4,18,35,51.4,17,27,10,17,14,63,21,1,Matches,Southampton,2024
Jack Stephens,eng ENG,DF,31-109,14.4,32,19,23,9,0,15,27,55.6,12,20,13,7,11,43,49,2,Matches,Southampton,2024
Yukinari Sugawara,jp JPN,"DF,MF",24-322,16.3,29,16,14,14,1,18,30,60.0,12,17,7,10,10,39,46,3,Matches,Southampton,2024
Kamaldeen Sulemana,gh GHA,"FW,MF",23-090,14.1,17,15,6,4,7,8,13,61.5,5,12,3,9,6,23,9,0,Matches,Southampton,2024
Adam Armstrong,eng ENG,"FW,MF",28-095,13.9,12,3,2,7,3,3,14,21.4,11,6,1,5,3,15,8,0,Matches,Southampton,2024
Cameron Archer,eng ENG,FW,23-299,15.5,11,7,6,3,2,2,9,22.2,7,5,1,4,2,13,10,0,Matches,Southampton,2024
James Bree,eng ENG,DF,27-217,10.9,18,13,8,9,1,10,25,40.0,15,9,3,6,8,26,28,0,Matches,Southampton,2024
Paul Onuachu,ng NGA,FW,30-353,11.4,7,2,1,5,1,3,7,42.9,4,7,2,5,1,8,16,1,Matches,Southampton,2024
Nathan Wood-Gordon,eng ENG,DF,22-350,6.9,10,7,6,3,1,5,8,62.5,3,8,5,3,4,14,26,2,Matches,Southampton,2024
William Smallbone,ie IRL,MF,25-084,7.2,18,11,8,8,2,7,21,33.3,14,8,0,8,2,20,12,2,Matches,Southampton,2024
Alex McCarthy,eng ENG,GK,35-164,5.0,0,0,0,0,0,0,0,,0,0,0,0,0,0,1,4,Matches,Southampton,2024
Adam Lallana,eng ENG,MF,37-006,4.0,8,5,4,4,0,2,12,16.7,10,4,1,3,5,13,5,0,Matches,Southampton,2024
Ben Brereton,cl CHI,FW,26-028,5.0,3,2,0,2,1,1,9,11.1,8,2,1,1,0,3,4,0,Matches,Southampton,2024
Ryan Fraser,sct SCO,"FW,DF",31-081,3.4,6,2,2,4,0,4,6,66.7,2,1,1,0,1,7,9,0,Matches,Southampton,2024
Welington,br BRA,"DF,MF",24-086,3.4,16,5,12,3,1,10,15,66.7,5,3,1,2,6,22,21,0,Matches,Southampton,2024
Ross Stewart,sct SCO,FW,28-309,3.2,3,2,1,0,2,2,6,33.3,4,3,0,3,0,3,6,0,Matches,Southampton,2024
Joe Lumley,eng ENG,GK,30-090,3.0,0,0,0,0,0,0,0,,0,0,0,0,0,0,3,3,Matches,Southampton,2024
Armel Bella Kotchap,de GER,DF,23-156,3.7,7,5,5,2,0,3,6,50.0,3,2,2,0,5,12,21,1,Matches,Southampton,2024
Charlie Taylor,eng ENG,DF,31-240,3.0,7,5,4,3,0,5,6,83.3,1,5,3,2,3,10,22,1,Matches,Southampton,2024
Albert Grønbaek,dk DEN,"FW,MF",23-358,1.6,4,1,1,1,2,3,10,30.0,7,1,1,0,0,4,1,0,Matches,Southampton,2024
Maxwel Cornet,ci CIV,FW,28-231,0.8,5,5,1,4,0,0,4,0.0,4,0,0,0,0,5,2,0,Matches,Southampton,2024
Samuel Edozie,eng ENG,"DF,FW",22-108,0.7,3,1,0,1,2,2,2,100.0,0,0,0,0,0,3,0,0,Matches,Southampton,2024
Jay Robinson,eng ENG,"MF,FW",18-062,0.4,2,1,2,0,0,0,0,,0,0,0,0,0,2,0,0,Matches,Southampton,2024
Samuel Amo-Ameyaw,eng ENG,"FW,DF",18-302,0.3,1,0,0,1,0,1,1,100.0,0,0,0,0,0,1,0,0,Matches,Southampton,2024
Ronnie Edwards,eng ENG,DF,22-049,0.1,0,0,0,0,0,0,0,,0,1,1,0,0,0,0,0,Matches,Southampton,2024
Carlos Alcaraz,ar ARG,MF,22-167,0.1,0,0,0,0,0,0,0,,0,0,0,0,1,1,0,0,Matches,Southampton,2024
Pedro Porro,es ESP,DF,25-245,28.0,63,46,31,22,10,42,73,57.5,31,44,17,27,34,97,82,1,Matches,Tottenham Hotspur,2024
Dejan Kulusevski,se SWE,"MF,FW",25-021,26.5,45,23,17,13,15,19,51,37.3,32,34,5,29,13,58,10,1,Matches,Tottenham Hotspur,2024
Dominic Solanke,eng ENG,FW,27-244,23.5,18,11,1,12,5,4,14,28.6,10,18,7,11,0,18,22,0,Matches,Tottenham Hotspur,2024
Brennan Johnson,wls WAL,FW,23-358,23.1,39,26,9,20,10,16,31,51.6,15,25,3,22,4,43,11,0,Matches,Tottenham Hotspur,2024
Guglielmo Vicario,it ITA,GK,28-221,23.0,0,0,0,0,0,0,0,,0,0,0,0,1,1,14,6,Matches,Tottenham Hotspur,2024
Son Heung-min,kr KOR,FW,32-312,22.6,17,9,3,8,6,5,23,21.7,18,10,0,10,5,22,16,1,Matches,Tottenham Hotspur,2024
Destiny Udogie,it ITA,DF,22-169,20.4,74,47,41,26,7,33,47,70.2,14,40,6,34,21,95,35,1,Matches,Tottenham Hotspur,2024
James Maddison,eng ENG,MF,28-174,20.1,31,19,8,16,7,9,29,31.0,20,15,4,11,12,43,19,1,Matches,Tottenham Hotspur,2024
Pape Matar Sarr,sn SEN,MF,22-244,20.2,47,35,18,23,6,12,24,50.0,12,24,10,14,27,74,22,1,Matches,Tottenham Hotspur,2024
Rodrigo Bentancur,uy URU,MF,27-325,17.4,38,20,17,17,4,19,39,48.7,20,25,8,17,36,74,35,1,Matches,Tottenham Hotspur,2024
Djed Spence,eng ENG,DF,24-280,18.8,45,33,24,14,7,23,30,76.7,7,27,9,18,20,65,68,1,Matches,Tottenham Hotspur,2024
Cristian Romero,ar ARG,DF,27-019,15.7,35,29,26,8,1,21,30,70.0,9,18,3,15,21,56,57,2,Matches,Tottenham Hotspur,2024
Archie Gray,eng ENG,"DF,MF",19-065,17.5,15,8,4,7,4,7,17,41.2,10,20,10,10,15,30,42,2,Matches,Tottenham Hotspur,2024
Yves Bissouma,ml MLI,MF,28-259,14.9,48,30,19,25,4,19,34,55.9,15,9,6,3,17,65,37,4,Matches,Tottenham Hotspur,2024
Radu Drăgușin,ro ROU,DF,23-102,13.9,10,6,8,2,0,6,12,50.0,6,22,16,6,15,25,49,4,Matches,Tottenham Hotspur,2024
Ben Davies,wls WAL,DF,32-022,13.5,16,11,7,8,1,9,16,56.3,7,26,18,8,12,28,72,1,Matches,Tottenham Hotspur,2024
Lucas Bergvall,se SWE,MF,19-103,13.5,39,19,14,20,5,17,32,53.1,15,18,8,10,24,63,22,3,Matches,Tottenham Hotspur,2024
Micky van de Ven,nl NED,DF,24-027,10.6,10,6,5,4,1,8,14,57.1,6,9,6,3,10,20,36,1,Matches,Tottenham Hotspur,2024
Mathys Tel,fr FRA,FW,20-019,8.2,12,5,2,5,5,2,9,22.2,7,8,1,7,1,13,4,2,Matches,Tottenham Hotspur,2024
Wilson Odobert,fr FRA,FW,20-169,8.0,12,4,4,3,5,7,12,58.3,5,5,0,5,3,15,3,1,Matches,Tottenham Hotspur,2024
Kevin Danso,at AUT,DF,26-239,7.4,7,5,4,3,0,6,10,60.0,4,9,9,0,3,10,49,1,Matches,Tottenham Hotspur,2024
Fraser Forster,eng ENG,GK,37-060,7.0,0,0,0,0,0,0,1,0.0,1,0,0,0,0,0,7,3,Matches,Tottenham Hotspur,2024
Antonín Kinský,cz CZE,GK,22-064,5.0,3,1,3,0,0,1,1,100.0,0,0,0,0,0,3,7,1,Matches,Tottenham Hotspur,2024
Timo Werner,de GER,"FW,MF",29-071,5.7,6,4,3,3,0,3,13,23.1,10,10,1,9,1,7,7,0,Matches,Tottenham Hotspur,2024
Richarlison,br BRA,FW,28-006,5.3,4,3,0,3,1,0,2,0.0,2,1,1,0,0,4,8,0,Matches,Tottenham Hotspur,2024
Mikey Moore,eng ENG,FW,17-278,3.1,0,0,0,0,0,0,2,0.0,2,2,0,2,1,1,3,0,Matches,Tottenham Hotspur,2024
Brandon Austin,eng ENG,GK,26-128,1.0,0,0,0,0,0,0,0,,0,0,0,0,0,0,1,0,Matches,Tottenham Hotspur,2024
Sergio Reguilón,es ESP,DF,28-151,1.4,4,3,1,3,0,2,3,66.7,1,4,0,4,2,6,3,0,Matches,Tottenham Hotspur,2024
Dane Scarlett,eng ENG,"FW,MF",21-053,0.4,1,0,0,1,0,0,0,,0,0,0,0,0,1,1,0,Matches,Tottenham Hotspur,2024
Alfie Dorrington,eng ENG,DF,20-026,0.2,0,0,0,0,0,0,0,,0,0,0,0,0,0,0,0,Matches,Tottenham Hotspur,2024
Will Lankshear,eng ENG,"FW,MF",20-026,0.1,0,0,0,0,0,0,0,,0,0,0,0,0,0,0,0,Matches,Tottenham Hotspur,2024
Max Kilman,eng ENG,DF,27-358,35.2,36,22,15,18,3,22,26,84.6,4,56,38,18,38,74,202,5,Matches,West Ham United,2024
Aaron Wan-Bissaka,eng ENG,DF,27-171,33.0,67,47,32,30,5,23,31,74.2,8,34,9,25,61,128,119,0,Matches,West Ham United,2024
Jarrod Bowen,eng ENG,"FW,MF",28-147,31.0,38,25,13,11,14,17,37,45.9,20,21,3,18,16,54,23,0,Matches,West Ham United,2024
Mohammed Kudus,gh GHA,"FW,MF",24-287,27.7,35,21,7,17,11,10,27,37.0,17,24,1,23,4,39,8,2,Matches,West Ham United,2024
Tomáš Souček,cz CZE,MF,30-078,26.9,43,20,20,20,3,23,40,57.5,17,38,20,18,19,62,79,1,Matches,West Ham United,2024
Lucas Paquetá,br BRA,"MF,FW",27-262,26.0,66,37,25,30,11,27,54,50.0,27,28,4,24,17,83,37,6,Matches,West Ham United,2024
Emerson Palmieri,it ITA,DF,30-286,23.5,60,31,37,18,5,27,48,56.3,21,32,8,24,21,81,59,0,Matches,West Ham United,2024
Alphonse Areola,fr FRA,GK,32-078,24.1,2,2,2,0,0,2,3,66.7,1,0,0,0,0,2,15,2,Matches,West Ham United,2024
Konstantinos Mavropanos,gr GRE,DF,27-156,21.7,33,22,22,10,1,15,26,57.7,11,24,17,7,39,72,118,1,Matches,West Ham United,2024
Edson Álvarez,mx MEX,MF,27-204,18.4,44,23,24,12,8,15,33,45.5,18,21,8,13,17,61,39,1,Matches,West Ham United,2024
Jean-Clair Todibo,fr FRA,DF,25-137,18.3,41,24,26,14,1,25,34,73.5,9,24,12,12,23,64,72,3,Matches,West Ham United,2024
Guido Rodríguez,ar ARG,MF,31-034,12.0,32,17,20,12,0,16,32,50.0,16,22,9,13,12,44,30,1,Matches,West Ham United,2024
Carlos Soler,es ESP,"MF,FW",28-134,15.3,15,11,8,6,1,7,23,30.4,16,19,6,13,8,23,21,2,Matches,West Ham United,2024
Łukasz Fabiański,pl POL,GK,40-028,11.9,0,0,0,0,0,0,1,0.0,1,0,0,0,0,0,5,1,Matches,West Ham United,2024
Michail Antonio,jm JAM,FW,35-049,9.3,2,2,0,1,1,2,3,66.7,1,6,0,6,0,2,2,0,Matches,West Ham United,2024
Vladimír Coufal,cz CZE,DF,32-267,10.6,19,12,12,5,2,8,19,42.1,11,13,11,2,8,27,38,1,Matches,West Ham United,2024
James Ward-Prowse,eng ENG,MF,30-196,10.0,18,13,8,6,4,6,15,40.0,9,6,3,3,6,24,13,0,Matches,West Ham United,2024
Aaron Cresswell,eng ENG,DF,35-152,8.5,11,7,5,5,1,9,11,81.8,2,9,4,5,8,19,36,0,Matches,West Ham United,2024
Crysencio Summerville,nl NED,"FW,MF",23-198,8.7,13,7,2,8,3,3,9,33.3,6,13,4,9,0,13,7,0,Matches,West Ham United,2024
Oliver Scarles,eng ENG,DF,19-155,6.6,17,11,13,3,1,13,21,61.9,8,14,2,12,10,27,24,0,Matches,West Ham United,2024
Niclas Füllkrug,de GER,FW,32-096,7.6,3,2,0,1,2,3,4,75.0,1,1,0,1,1,4,12,0,Matches,West Ham United,2024
Danny Ings,eng ENG,"FW,MF",32-297,3.2,4,2,2,2,0,1,3,33.3,2,5,0,5,1,5,4,0,Matches,West Ham United,2024
Andy Irving,sct SCO,MF,25-003,1.8,7,4,3,3,1,1,5,20.0,4,5,1,4,1,8,5,0,Matches,West Ham United,2024
Evan Ferguson,ie IRL,FW,20-209,1.7,3,1,0,1,2,0,0,,0,2,1,1,1,4,1,0,Matches,West Ham United,2024
Luis Guilherme,br BRA,"MF,FW",19-096,1.5,1,0,1,0,0,0,3,0.0,3,7,0,7,3,4,2,0,Matches,West Ham United,2024
Lewis Orford,eng ENG,MF,19-087,0.5,0,0,0,0,0,0,0,,0,1,0,1,1,1,0,0,Matches,West Ham United,2024
Kaelan Casey,eng ENG,DF,20-200,0.0,0,0,0,0,0,0,0,,0,0,0,0,0,0,1,0,Matches,West Ham United,2024
Rayan Aït-Nouri,dz ALG,DF,23-344,32.8,85,55,51,26,8,41,68,60.3,27,41,6,35,25,110,70,1,Matches,Wolverhampton Wanderers,2024
João Gomes,br BRA,MF,24-093,31.5,105,62,53,48,4,42,103,40.8,61,42,4,38,25,130,32,0,Matches,Wolverhampton Wanderers,2024
Nélson Semedo,pt POR,DF,31-181,30.6,59,34,31,21,7,31,54,57.4,23,29,10,19,23,82,101,3,Matches,Wolverhampton Wanderers,2024
Jørgen Strand Larsen,no NOR,FW,25-099,27.7,9,6,2,3,4,4,27,14.8,23,18,4,14,6,15,28,0,Matches,Wolverhampton Wanderers,2024
André,br BRA,MF,23-304,26.0,88,53,40,40,8,35,61,57.4,26,42,8,34,35,123,30,1,Matches,Wolverhampton Wanderers,2024
José Sá,pt POR,GK,32-119,28.0,2,2,2,0,0,2,2,100.0,0,0,0,0,0,2,15,1,Matches,Wolverhampton Wanderers,2024
Matheus Cunha,br BRA,"MF,FW",25-354,27.6,35,21,16,15,4,11,36,30.6,25,21,1,20,17,52,23,0,Matches,Wolverhampton Wanderers,2024
Toti Gomes,pt POR,DF,26-120,27.0,57,41,40,14,3,33,42,78.6,9,28,17,11,24,81,142,5,Matches,Wolverhampton Wanderers,2024
Matt Doherty,ie IRL,DF,33-120,22.5,37,20,25,12,0,16,24,66.7,8,27,15,12,22,59,95,3,Matches,Wolverhampton Wanderers,2024
Jean-Ricner Bellegarde,fr FRA,"MF,FW",26-323,17.6,37,22,17,17,3,13,19,68.4,6,19,3,16,10,47,18,1,Matches,Wolverhampton Wanderers,2024
Santiago Bueno,uy URU,DF,26-188,18.7,40,21,21,18,1,17,22,77.3,5,35,20,15,15,55,70,0,Matches,Wolverhampton Wanderers,2024
Mario Lemina,ga GAB,"MF,DF",31-257,15.2,51,31,27,19,5,20,29,69.0,9,12,7,5,27,78,50,3,Matches,Wolverhampton Wanderers,2024
Emmanuel Agbadou,ci CIV,DF,27-333,13.7,27,18,18,9,0,11,17,64.7,6,19,13,6,11,38,82,0,Matches,Wolverhampton Wanderers,2024
Marshall Munetsi,zw ZIM,"MF,FW",28-328,10.8,22,10,6,10,6,12,21,57.1,9,13,1,12,6,28,16,0,Matches,Wolverhampton Wanderers,2024
Craig Dawson,eng ENG,DF,35-010,10.8,15,3,8,6,1,12,15,80.0,3,16,11,5,9,24,52,1,Matches,Wolverhampton Wanderers,2024
Gonçalo Guedes,pt POR,"MF,FW",28-168,9.3,14,4,2,5,7,3,15,20.0,12,9,0,9,5,19,3,0,Matches,Wolverhampton Wanderers,2024
Sam Johnstone,eng ENG,GK,32-052,7.0,0,0,0,0,0,0,1,0.0,1,0,0,0,0,0,7,0,Matches,Wolverhampton Wanderers,2024
Pablo Sarabia,es ESP,"MF,FW",33-005,8.3,15,8,4,8,3,9,15,60.0,6,10,0,10,4,19,7,1,Matches,Wolverhampton Wanderers,2024
Rodrigo Gomes,pt POR,"DF,FW",21-313,7.8,21,13,12,9,0,10,19,52.6,9,8,1,7,5,26,20,1,Matches,Wolverhampton Wanderers,2024
Hwang Hee-chan,kr KOR,"MF,FW",29-110,7.2,6,4,2,1,3,2,6,33.3,4,9,0,9,2,8,11,0,Matches,Wolverhampton Wanderers,2024
Yerson Mosquera,co COL,DF,24-014,4.9,11,7,9,2,0,9,14,64.3,5,13,10,3,10,21,14,0,Matches,Wolverhampton Wanderers,2024
Tommy Doyle,eng ENG,MF,23-211,5.4,11,6,6,3,2,6,15,40.0,9,11,5,6,5,16,11,1,Matches,Wolverhampton Wanderers,2024
Carlos Forbs,pt POR,"MF,FW",21-058,2.7,8,5,5,2,1,4,6,66.7,2,3,0,3,1,9,2,1,Matches,Wolverhampton Wanderers,2024
Daniel Bentley,eng ENG,GK,31-307,1.0,0,0,0,0,0,0,0,,0,0,0,0,0,0,0,0,Matches,Wolverhampton Wanderers,2024
Pedro Lima,br BRA,DF,18-319,0.8,1,0,0,0,1,1,3,33.3,2,0,0,0,2,3,5,0,Matches,Wolverhampton Wanderers,2024
Daniel Podence,pt POR,"MF,FW",29-207,0.5,0,0,0,0,0,0,1,0.0,1,0,0,0,0,0,0,0,Matches,Wolverhampton Wanderers,2024
Nasser Djiga,bf BFA,"DF,FW",22-182,0.2,0,0,0,0,0,0,0,,0,0,0,0,2,2,3,1,Matches,Wolverhampton Wanderers,2024
Chiquinho,pt POR,MF,25-100,0.1,0,0,0,0,0,0,0,,0,0,0,0,0,0,0,0,Matches,Wolverhampton Wanderers,2024
Mateus Mane,,MF,,0.0,0,0,0,0,0,0,0,,0,1,0,1,0,0,0,0,Matches,Wolverhampton Wanderers,2024
Alfie Pond,eng ENG,DF,21-076,0.0,0,0,0,0,0,0,0,,0,0,0,0,0,0,0,0,Matches,Wolverhampton Wanderers,2024
Boubacar Traoré,ml MLI,MF,23-269,0.0,2,0,0,2,0,1,1,100.0,0,0,0,0,0,2,0,0,Matches,Wolverhampton Wanderers,2024
