,Player,Nation,Pos,Age,90s,tackles_Tkl,tackles_TklW,tackles_Def 3rd,tackles_Mid 3rd,tackles_Att 3rd,challenges_Tkl,challenges_Att,challenges_Tkl%,challenges_Lost,blocks_Blocks,blocks_Sh,blocks_Pass,Int,Tkl+Int,Clr,Err,Matches,Team,Season
0,Pedri,es ESP,MF,22-165,28.6,55,30,13,33,9,22,62,35.5,40,40,3,37,26,81,21,1,Matches,Barcelona,2024
1,Jules Koundé,fr FRA,DF,26-178,28.9,63,43,29,23,11,44,66,66.7,22,35,5,30,20,83,68,2,Matches,Barcelona,2024
2,Robert Lewandowski,pl POL,FW,36-261,27.1,9,4,1,5,3,4,10,40.0,6,14,2,12,3,12,24,0,Matches,Barcelona,2024
3,Raphinha,br BRA,"FW,MF",28-146,27.8,35,21,6,18,11,19,35,54.3,16,26,2,24,8,43,24,0,Matches,Barcelona,2024
4,Lamine Yamal,es ESP,FW,17-300,27.7,39,26,5,17,17,15,34,44.1,19,12,0,12,13,52,3,0,Matches,Barcelona,2024
5,Pau Cubarsí,es ESP,DF,18-107,26.0,28,18,18,7,3,16,25,64.0,9,10,8,2,13,41,75,1,Matches,Barcelona,2024
6,Iñigo Martínez,es ESP,DF,33-357,25.7,23,13,18,5,0,15,21,71.4,6,18,7,11,18,41,104,1,Matches,Barcelona,2024
7,Alejandro Balde,es ESP,DF,21-203,23.1,16,10,9,4,3,9,14,64.3,5,23,4,19,5,21,25,0,Matches,Barcelona,2024
8,Marc Casado,es ESP,MF,21-237,17.9,44,25,7,30,7,20,41,48.8,21,20,5,15,22,66,22,1,Matches,Barcelona,2024
9,Iñaki Peña,es ESP,GK,26-068,14.5,0,0,0,0,0,0,2,0.0,2,0,0,0,0,0,20,1,Matches,Barcelona,2024
10,Wojciech Szczęsny,pl POL,GK,35-021,13.0,1,1,1,0,0,0,0,,0,0,0,0,0,1,14,1,Matches,Barcelona,2024
11,Gavi,es ESP,"MF,FW",20-277,9.9,19,15,4,11,4,10,18,55.6,8,13,1,12,10,29,5,0,Matches,Barcelona,2024
12,Dani Olmo,es ESP,"MF,FW",27-002,11.4,14,9,8,4,2,3,11,27.3,8,6,3,3,3,17,10,1,Matches,Barcelona,2024
13,Ferrán Torres,es ESP,"FW,MF",25-069,11.3,7,4,2,2,3,3,8,37.5,5,7,1,6,4,11,5,0,Matches,Barcelona,2024
14,Eric García,es ESP,"MF,DF",24-120,13.7,28,16,7,19,2,14,20,70.0,6,20,7,13,10,38,36,0,Matches,Barcelona,2024
15,Fermin López,es ESP,"MF,FW",21-363,11.5,18,14,3,8,7,7,25,28.0,18,8,0,8,4,22,3,0,Matches,Barcelona,2024
16,Ronald Araújo,uy URU,DF,26-063,7.1,12,9,6,5,1,4,4,100.0,0,6,4,2,8,20,19,0,Matches,Barcelona,2024
17,Gerard Martín,es ESP,DF,23-128,9.8,20,9,8,7,5,10,15,66.7,5,15,2,13,8,28,25,0,Matches,Barcelona,2024
18,Frenkie de Jong,nl NED,MF,27-362,10.1,15,9,4,5,6,7,14,50.0,7,6,0,6,5,20,6,1,Matches,Barcelona,2024
19,Marc-André ter Stegen,de GER,GK,33-009,6.5,0,0,0,0,0,0,1,0.0,1,0,0,0,0,0,2,2,Matches,Barcelona,2024
20,Héctor Fort,es ESP,DF,18-280,6.0,13,8,6,4,3,10,15,66.7,5,11,0,11,6,19,15,0,Matches,Barcelona,2024
21,Pablo Torre,es ESP,"MF,FW",22-036,3.4,5,4,1,3,1,2,4,50.0,2,0,0,0,3,8,5,1,Matches,Barcelona,2024
22,Marc Bernal,es ESP,MF,17-348,2.7,8,6,2,5,1,7,8,87.5,1,5,1,4,1,9,4,0,Matches,Barcelona,2024
23,Ansu Fati,es ESP,FW,22-190,2.6,4,1,0,2,2,1,2,50.0,1,1,0,1,1,5,0,1,Matches,Barcelona,2024
24,Pau Victor Delgado,es ESP,FW,23-164,3.3,2,1,0,1,1,0,3,0.0,3,6,1,5,2,4,5,0,Matches,Barcelona,2024
25,Sergi Dominguez,es ESP,DF,20-038,1.9,1,1,1,0,0,0,0,,0,0,0,0,3,4,7,0,Matches,Barcelona,2024
26,Andreas Christensen,dk DEN,DF,29-029,1.3,1,1,0,1,0,1,1,100.0,0,0,0,0,0,1,3,0,Matches,Barcelona,2024
27,Daniel Rodriguez,es ESP,FW,19-273,0.4,0,0,0,0,0,0,0,,0,1,0,1,0,0,0,0,Matches,Barcelona,2024
28,Federico Valverde,uy URU,"MF,DF",26-291,29.7,42,26,17,20,5,24,35,68.6,11,35,6,29,51,93,48,1,Matches,Real Madrid,2024
29,Kylian Mbappé,fr FRA,FW,26-140,28.3,8,5,1,3,4,1,5,20.0,4,3,0,3,1,9,1,0,Matches,Real Madrid,2024
30,Thibaut Courtois,be BEL,GK,32-363,28.0,0,0,0,0,0,0,0,,0,0,0,0,1,1,13,1,Matches,Real Madrid,2024
31,Aurélien Tchouaméni,fr FRA,"DF,MF",25-102,27.3,41,20,21,18,2,19,38,50.0,19,31,22,9,43,84,80,1,Matches,Real Madrid,2024
32,Antonio Rüdiger,de GER,DF,32-067,25.5,20,13,14,6,0,11,15,73.3,4,22,14,8,9,29,96,1,Matches,Real Madrid,2024
33,Jude Bellingham,eng ENG,MF,21-314,24.6,55,31,16,25,14,26,39,66.7,13,32,2,30,25,80,19,1,Matches,Real Madrid,2024
34,Vinicius Júnior,br BRA,FW,24-301,23.7,20,10,7,4,9,4,17,23.5,13,6,0,6,3,23,1,2,Matches,Real Madrid,2024
35,Lucas Vázquez,es ESP,DF,33-312,22.4,51,32,30,14,7,25,46,54.3,21,22,5,17,17,68,31,0,Matches,Real Madrid,2024
36,Rodrygo,br BRA,"FW,MF",24-120,21.4,21,14,14,5,2,7,23,30.4,16,18,1,17,11,32,9,0,Matches,Real Madrid,2024
37,Fran Garcia,es ESP,DF,25-268,20.3,38,26,22,12,4,19,33,57.6,14,22,4,18,23,61,62,1,Matches,Real Madrid,2024
38,Raúl Asencio,es ESP,DF,22-085,15.9,19,13,16,3,0,9,12,75.0,3,6,4,2,12,31,77,2,Matches,Real Madrid,2024
39,Brahim Díaz,ma MAR,"FW,MF",25-279,14.3,24,18,9,12,3,7,18,38.9,11,16,1,15,4,28,1,1,Matches,Real Madrid,2024
40,Luka Modrić,hr CRO,MF,39-242,16.8,28,18,16,11,1,14,31,45.2,17,14,5,9,23,51,16,0,Matches,Real Madrid,2024
41,Ferland Mendy,fr FRA,DF,29-335,11.2,17,14,7,6,4,9,12,75.0,3,11,4,7,9,26,8,1,Matches,Real Madrid,2024
42,Dani Ceballos,es ESP,MF,28-275,10.8,35,19,15,15,5,16,27,59.3,11,15,3,12,13,48,9,1,Matches,Real Madrid,2024
43,Eduardo Camavinga,fr FRA,"MF,DF",22-180,12.2,42,26,23,16,3,19,33,57.6,14,24,8,16,18,60,23,0,Matches,Real Madrid,2024
44,Éder Militão,br BRA,DF,27-111,10.4,19,17,14,5,0,7,12,58.3,5,13,8,5,12,31,35,0,Matches,Real Madrid,2024
45,Arda Güler,tr TUR,"MF,FW",20-073,10.5,22,11,8,6,8,7,18,38.9,11,14,0,14,5,27,8,0,Matches,Real Madrid,2024
46,Dani Carvajal,es ESP,DF,33-118,6.8,12,8,7,3,2,9,12,75.0,3,8,3,5,10,22,19,1,Matches,Real Madrid,2024
47,Andriy Lunin,ua UKR,GK,26-087,5.0,0,0,0,0,0,0,0,,0,0,0,0,0,0,2,0,Matches,Real Madrid,2024
48,David Alaba,at AUT,DF,32-319,3.5,1,0,1,0,0,0,0,,0,5,5,0,6,7,7,0,Matches,Real Madrid,2024
49,Endrick,br BRA,FW,18-292,2.5,1,1,1,0,0,1,3,33.3,2,0,0,0,3,4,1,0,Matches,Real Madrid,2024
50,Fran,es ESP,GK,19-319,1.0,0,0,0,0,0,0,0,,0,0,0,0,0,0,2,0,Matches,Real Madrid,2024
51,Jacobo Ramón,es ESP,DF,20-123,0.3,2,1,2,0,0,1,1,100.0,0,0,0,0,0,2,0,0,Matches,Real Madrid,2024
52,Jesús Vallejo,es ESP,DF,28-124,0.1,0,0,0,0,0,0,0,,0,0,0,0,0,0,2,0,Matches,Real Madrid,2024
53,Chema,es ESP,MF,20-014,0.1,0,0,0,0,0,0,0,,0,0,0,0,0,0,1,0,Matches,Real Madrid,2024
54,Lorenzo Aguado,es ESP,DF,22-232,0.1,0,0,0,0,0,0,0,,0,0,0,0,0,0,2,0,Matches,Real Madrid,2024
55,Daniel Yáñez,es ESP,FW,18-042,0.0,0,0,0,0,0,0,0,,0,0,0,0,0,0,0,0,Matches,Real Madrid,2024
56,Jan Oblak,si SVN,GK,32-122,33.0,0,0,0,0,0,0,0,,0,0,0,0,0,0,15,2,Matches,Atletico Madrid,2024
57,Antoine Griezmann,fr FRA,"FW,MF",34-049,26.0,30,17,13,13,4,7,29,24.1,22,16,1,15,6,36,23,1,Matches,Atletico Madrid,2024
58,Julián Álvarez,ar ARG,FW,25-098,25.2,24,16,5,10,9,8,28,28.6,20,14,0,14,0,24,10,1,Matches,Atletico Madrid,2024
59,Pablo Barrios,es ESP,MF,21-328,24.6,44,25,21,20,3,22,45,48.9,23,14,4,10,33,77,33,7,Matches,Atletico Madrid,2024
60,Marcos Llorente,es ESP,"DF,MF",30-099,23.9,61,45,34,24,3,33,48,68.8,15,27,7,20,22,83,47,1,Matches,Atletico Madrid,2024
61,Giuliano Simeone,ar ARG,MF,22-142,19.0,24,12,6,8,10,14,28,50.0,14,19,2,17,12,36,18,0,Matches,Atletico Madrid,2024
62,Robin Le Normand,es ESP,DF,28-179,20.9,25,16,21,4,0,11,18,61.1,7,17,8,9,8,33,108,1,Matches,Atletico Madrid,2024
63,Clément Lenglet,fr FRA,DF,29-326,19.9,22,14,16,6,0,8,11,72.7,3,24,18,6,20,42,96,1,Matches,Atletico Madrid,2024
64,Rodrigo De Paul,ar ARG,MF,30-350,20.0,28,23,11,13,4,13,30,43.3,17,22,2,20,5,33,13,3,Matches,Atletico Madrid,2024
65,Conor Gallagher,eng ENG,MF,25-092,17.2,42,30,16,16,10,20,46,43.5,26,23,5,18,19,61,23,0,Matches,Atletico Madrid,2024
66,José María Giménez,uy URU,DF,30-109,20.2,22,14,15,7,0,16,27,59.3,11,26,16,10,25,47,104,2,Matches,Atletico Madrid,2024
67,Javi Galán,es ESP,DF,30-171,17.3,48,29,29,15,4,24,46,52.2,22,12,3,9,9,57,41,0,Matches,Atletico Madrid,2024
68,Samuel Lino,br BRA,"MF,DF",25-137,14.4,25,13,20,4,1,18,45,40.0,27,19,4,15,7,32,12,0,Matches,Atletico Madrid,2024
69,Koke,es ESP,MF,33-121,17.9,43,22,17,20,6,20,38,52.6,18,21,2,19,18,61,25,1,Matches,Atletico Madrid,2024
70,Nahuel Molina,ar ARG,DF,27-033,16.0,40,17,19,20,1,29,52,55.8,23,16,3,13,11,51,49,0,Matches,Atletico Madrid,2024
71,Alexander Sørloth,no NOR,FW,29-155,14.8,8,4,2,4,2,3,5,60.0,2,5,1,4,1,9,23,0,Matches,Atletico Madrid,2024
72,Reinildo Mandava,mz MOZ,DF,31-108,10.5,18,11,10,7,1,10,18,55.6,8,11,5,6,16,34,35,0,Matches,Atletico Madrid,2024
73,César Azpilicueta,es ESP,DF,35-254,8.2,23,12,11,8,4,16,22,72.7,6,6,2,4,3,26,27,0,Matches,Atletico Madrid,2024
74,Axel Witsel,be BEL,DF,36-117,8.5,13,12,4,8,1,10,12,83.3,2,15,8,7,9,22,32,1,Matches,Atletico Madrid,2024
75,Rodrigo Riquelme,es ESP,"MF,DF",25-037,5.7,11,5,4,6,1,6,11,54.5,5,3,0,3,2,13,3,0,Matches,Atletico Madrid,2024
76,Ángel Correa,ar ARG,"FW,MF",30-061,8.1,8,2,4,1,3,4,14,28.6,10,9,0,9,4,12,7,0,Matches,Atletico Madrid,2024
77,Juan Musso,ar ARG,GK,31-003,1.0,0,0,0,0,0,0,0,,0,0,0,0,0,0,0,0,Matches,Atletico Madrid,2024
78,Thomas Lemar,fr FRA,MF,29-178,0.7,2,1,1,1,0,2,4,50.0,2,0,0,0,0,2,0,0,Matches,Atletico Madrid,2024
79,Adrian Niño,es ESP,FW,20-324,0.1,0,0,0,0,0,0,0,,0,0,0,0,0,0,0,0,Matches,Atletico Madrid,2024
80,Iñaki Williams,gh GHA,FW,30-328,29.0,17,10,4,8,5,12,23,52.2,11,34,5,29,12,29,32,0,Matches,Athletic Club,2024
81,Daniel Vivian,es ESP,DF,25-298,25.7,37,23,21,13,3,19,30,63.3,11,24,9,15,38,75,120,2,Matches,Athletic Club,2024
82,Álex Berenguer,es ESP,"FW,MF",29-309,23.0,29,13,4,16,9,13,26,50.0,13,18,2,16,9,38,17,0,Matches,Athletic Club,2024
83,Mikel Jauregizar,es ESP,MF,21-178,21.8,76,43,23,40,13,39,74,52.7,35,22,3,19,26,102,28,2,Matches,Athletic Club,2024
84,Nico Williams,es ESP,FW,22-301,21.3,27,17,10,11,6,10,31,32.3,21,19,1,18,6,33,9,0,Matches,Athletic Club,2024
85,Beñat Prados,es ESP,MF,24-090,17.9,51,33,19,24,8,23,51,45.1,28,21,2,19,28,79,25,0,Matches,Athletic Club,2024
86,Gorka Guruzeta,es ESP,FW,28-239,18.1,15,8,1,12,2,7,28,25.0,21,27,4,23,8,23,19,0,Matches,Athletic Club,2024
87,Aitor Paredes,es ESP,DF,25-010,18.1,11,9,8,3,0,5,12,41.7,7,22,12,10,22,33,107,4,Matches,Athletic Club,2024
88,Yuri Berchiche,es ESP,DF,35-088,18.7,32,20,18,11,3,19,30,63.3,11,20,3,17,20,52,47,2,Matches,Athletic Club,2024
89,Yeray Álvarez,es ESP,DF,30-105,17.8,24,13,13,9,2,14,20,70.0,6,10,6,4,33,57,104,1,Matches,Athletic Club,2024
90,Oihan Sancet,es ESP,MF,25-014,16.3,12,7,6,5,1,4,12,33.3,8,9,0,9,5,17,5,0,Matches,Athletic Club,2024
91,Unai Simón,es ESP,GK,27-332,17.0,0,0,0,0,0,0,0,,0,1,0,1,1,1,10,4,Matches,Athletic Club,2024
92,Andoni Gorosabel,es ESP,DF,28-278,15.6,43,25,27,9,7,27,41,65.9,14,17,2,15,17,60,54,0,Matches,Athletic Club,2024
93,Óscar de Marcos,es ESP,DF,36-025,15.3,28,13,13,11,4,19,34,55.9,15,15,1,14,14,42,30,0,Matches,Athletic Club,2024
94,Iñigo Ruiz de Galarreta,es ESP,MF,31-276,13.9,34,21,11,17,6,19,29,65.5,10,8,3,5,12,46,9,2,Matches,Athletic Club,2024
95,Julen Agirrezabala,es ESP,GK,24-134,13.4,0,0,0,0,0,0,1,0.0,1,0,0,0,0,0,4,0,Matches,Athletic Club,2024
96,Unai Gómez,es ESP,"MF,FW",21-349,12.3,10,6,3,6,1,4,6,66.7,2,12,1,11,2,12,12,0,Matches,Athletic Club,2024
97,Adama Boiro,es ESP,DF,22-321,11.2,20,11,11,7,2,10,14,71.4,4,8,3,5,12,32,26,1,Matches,Athletic Club,2024
98,Mikel Vesga,es ESP,MF,31-353,9.8,20,14,7,12,1,10,26,38.5,16,10,1,9,13,33,20,0,Matches,Athletic Club,2024
99,Iñigo Lekue,es ESP,DF,32-005,7.6,15,12,12,3,0,9,17,52.9,8,7,2,5,7,22,26,2,Matches,Athletic Club,2024
100,Álvaro djaló,es ESP,FW,25-266,6.7,7,5,3,2,2,1,3,33.3,2,3,0,3,1,8,4,0,Matches,Athletic Club,2024
101,Unai Núñez,es ESP,DF,28-099,6.5,9,4,6,3,0,3,6,50.0,3,4,4,0,17,26,42,1,Matches,Athletic Club,2024
102,Maroan Sannadi,es ESP,FW,24-097,5.7,1,0,1,0,0,1,4,25.0,3,1,0,1,0,1,1,0,Matches,Athletic Club,2024
103,Alex Padilla,es ESP,GK,21-250,3.6,0,0,0,0,0,0,0,,0,0,0,0,0,0,2,1,Matches,Athletic Club,2024
104,Ander Herrera,es ESP,MF,35-268,3.0,8,4,1,7,0,3,6,50.0,3,1,0,1,2,10,10,0,Matches,Athletic Club,2024
105,Peio Canales,es ESP,"MF,FW",20-112,2.1,2,2,0,0,2,1,1,100.0,0,1,0,1,2,4,1,0,Matches,Athletic Club,2024
106,Nicolás Serrano,es ESP,FW,22-065,1.2,1,1,0,1,0,1,3,33.3,2,4,0,4,1,2,1,0,Matches,Athletic Club,2024
107,Javi Martón,es ESP,"FW,MF",26-003,0.6,0,0,0,0,0,0,0,,0,0,0,0,0,0,0,0,Matches,Athletic Club,2024
108,Adu Ares,es ESP,FW,23-209,0.2,0,0,0,0,0,0,1,0.0,1,0,0,0,0,0,0,0,Matches,Athletic Club,2024
109,Endika Buján,es ESP,FW,22-113,0.1,0,0,0,0,0,0,1,0.0,1,0,0,0,0,0,0,0,Matches,Athletic Club,2024
110,Diego Llorente,es ESP,DF,31-266,28.0,36,20,23,12,1,25,38,65.8,13,29,20,9,43,79,154,1,Matches,Real Betis,2024
111,Johnny Cardoso,us USA,MF,23-231,21.7,51,28,12,31,8,20,50,40.0,30,26,12,14,46,97,58,1,Matches,Real Betis,2024
112,Marc Bartra,es ESP,DF,34-114,20.5,26,16,17,9,0,12,20,60.0,8,33,21,12,30,56,141,0,Matches,Real Betis,2024
113,Romain Perraud,fr FRA,DF,27-229,20.1,35,21,15,15,5,20,45,44.4,25,15,3,12,21,56,66,1,Matches,Real Betis,2024
114,Abde Ezzalzouli,ma MAR,"FW,MF",23-143,19.6,35,25,17,15,3,14,25,56.0,11,20,3,17,6,41,15,0,Matches,Real Betis,2024
115,Natan,br BRA,DF,24-092,20.2,32,21,21,9,2,23,27,85.2,4,22,13,9,23,55,104,1,Matches,Real Betis,2024
116,Sergi Altimira,es ESP,MF,23-257,19.5,54,32,15,33,6,32,55,58.2,23,27,1,26,20,74,40,2,Matches,Real Betis,2024
117,Youssouf Sabaly,sn SEN,DF,32-065,17.3,39,25,20,15,4,24,32,75.0,8,20,3,17,13,52,39,0,Matches,Real Betis,2024
118,Pablo Fornals,es ESP,"MF,FW",29-076,17.1,16,10,9,6,1,6,24,25.0,18,19,1,18,20,36,13,1,Matches,Real Betis,2024
119,Adrián,es ESP,GK,38-126,15.0,0,0,0,0,0,0,2,0.0,2,0,0,0,0,0,9,2,Matches,Real Betis,2024
120,Rui Silva,pt POR,GK,31-091,15.0,0,0,0,0,0,0,1,0.0,1,1,0,1,0,0,7,0,Matches,Real Betis,2024
121,Isco,es ESP,MF,33-018,14.6,16,9,1,11,4,7,26,26.9,19,9,0,9,8,24,6,0,Matches,Real Betis,2024
122,Vitor Roque,br BRA,FW,20-070,13.7,11,6,1,6,4,1,5,20.0,4,5,0,5,7,18,4,0,Matches,Real Betis,2024
123,Giovani Lo Celso,ar ARG,"MF,FW",29-030,14.5,33,22,8,16,9,16,24,66.7,8,14,2,12,5,38,3,1,Matches,Real Betis,2024
124,Ricardo Rodríguez,ch SUI,DF,32-257,12.3,25,13,13,5,7,16,25,64.0,9,8,1,7,6,31,45,0,Matches,Real Betis,2024
125,Antony,br BRA,FW,25-074,12.2,18,7,3,8,7,5,17,29.4,12,10,1,9,9,27,9,1,Matches,Real Betis,2024
126,Jesus Rodríguez,es ESP,FW,19-169,10.8,16,14,6,6,4,5,12,41.7,7,13,0,13,6,22,2,0,Matches,Real Betis,2024
127,Marc Roca,es ESP,MF,28-164,10.1,20,14,10,9,1,9,17,52.9,8,17,5,12,14,34,14,2,Matches,Real Betis,2024
128,Cucho,co COL,FW,26-019,9.7,12,8,1,5,6,5,9,55.6,4,13,1,12,6,18,3,0,Matches,Real Betis,2024
129,Aitor Ruibal,es ESP,"DF,FW",29-048,11.0,21,15,15,3,3,16,27,59.3,11,15,4,11,11,32,27,0,Matches,Real Betis,2024
130,Ezequiel Ávila,ar ARG,FW,31-092,7.5,8,3,2,2,4,4,10,40.0,6,4,0,4,2,10,8,0,Matches,Real Betis,2024
131,Héctor Bellerín,es ESP,DF,30-051,6.4,13,7,7,4,2,10,17,58.8,7,5,3,2,6,19,21,0,Matches,Real Betis,2024
132,Cédric Bakambu,cd COD,FW,34-028,6.9,6,4,0,5,1,3,7,42.9,4,11,2,9,0,6,5,0,Matches,Real Betis,2024
133,William Carvalho,pt POR,MF,33-032,4.3,5,3,1,4,0,3,5,60.0,2,5,1,4,3,8,4,0,Matches,Real Betis,2024
134,Fran Vieites,es ESP,GK,26-002,4.0,0,0,0,0,0,0,0,,0,0,0,0,0,0,1,0,Matches,Real Betis,2024
135,Ángel Ortíz,es ESP,DF,20-288,3.8,10,7,7,3,0,6,15,40.0,9,6,0,6,5,15,7,0,Matches,Real Betis,2024
136,Iker Losada,es ESP,"MF,FW",23-281,3.7,10,7,2,4,4,5,10,50.0,5,2,0,2,3,13,2,0,Matches,Real Betis,2024
137,Assane Diao,sn SEN,FW,19-244,3.1,5,3,1,3,1,4,9,44.4,5,3,0,3,0,5,3,0,Matches,Real Betis,2024
138,Juanmi,es ESP,"FW,MF",31-354,2.7,7,4,3,3,1,4,6,66.7,2,4,0,4,1,8,4,0,Matches,Real Betis,2024
139,Nabil Fekir,fr FRA,MF,31-295,2.0,3,2,1,1,1,1,2,50.0,1,2,0,2,0,3,0,0,Matches,Real Betis,2024
140,Carlos Guirao,es ESP,MF,22-012,1.2,5,3,1,4,0,4,6,66.7,2,1,1,0,3,8,2,0,Matches,Real Betis,2024
141,Mateo Flores,es ESP,MF,21-032,1.7,3,1,3,0,0,1,1,100.0,0,1,0,1,2,5,3,0,Matches,Real Betis,2024
142,Rodri,es ESP,FW,24-358,1.3,2,1,1,1,0,1,2,50.0,1,2,1,1,1,3,1,1,Matches,Real Betis,2024
143,Sergio Arribas,es ESP,DF,22-088,1.0,7,4,4,3,0,6,7,85.7,1,2,2,0,3,10,4,0,Matches,Real Betis,2024
144,Pablo Garcia,es ESP,FW,18-267,0.3,0,0,0,0,0,0,0,,0,1,0,1,0,0,0,0,Matches,Real Betis,2024
145,Sergi Cardona,es ESP,DF,25-305,30.7,66,44,40,19,7,45,73,61.6,28,48,7,41,33,99,114,1,Matches,Villarreal,2024
146,Santi Comesaña,es ESP,MF,28-216,26.1,83,47,42,32,9,40,70,57.1,30,49,17,32,17,100,47,1,Matches,Villarreal,2024
147,Kiko Femenía,es ESP,DF,34-096,24.7,50,34,34,14,2,33,57,57.9,24,21,10,11,40,90,62,3,Matches,Villarreal,2024
148,Alex Baena,es ESP,MF,23-293,25.2,26,14,6,13,7,9,33,27.3,24,28,2,26,21,47,19,2,Matches,Villarreal,2024
149,Logan Costa,cv CPV,DF,24-038,24.7,35,19,22,12,1,22,25,88.0,3,20,11,9,17,52,100,1,Matches,Villarreal,2024
150,Thierno Barry,fr FRA,FW,22-200,24.3,11,8,2,5,4,4,10,40.0,6,15,2,13,0,11,18,0,Matches,Villarreal,2024
151,Daniel Parejo,es ESP,MF,36-023,23.2,48,37,24,19,5,26,48,54.2,22,21,6,15,22,70,33,1,Matches,Villarreal,2024
152,Pape Gueye,sn SEN,MF,26-105,22.0,52,25,21,23,8,19,26,73.1,7,28,10,18,24,76,48,1,Matches,Villarreal,2024
153,Diego Conde,es ESP,GK,26-193,20.8,2,2,2,0,0,2,4,50.0,2,0,0,0,1,3,9,2,Matches,Villarreal,2024
154,Yeremi Pino,es ESP,MF,22-201,18.5,52,27,16,28,8,27,54,50.0,27,35,3,32,8,60,16,0,Matches,Villarreal,2024
155,Ayoze Pérez,es ESP,FW,31-284,19.6,23,12,5,15,3,6,22,27.3,16,16,0,16,7,30,13,0,Matches,Villarreal,2024
156,Juan Foyth,ar ARG,DF,27-117,13.9,23,14,14,5,4,10,15,66.7,5,22,13,9,17,40,97,3,Matches,Villarreal,2024
157,Raúl Albiol,es ESP,DF,39-247,13.2,10,9,9,1,0,6,10,60.0,4,10,9,1,6,16,69,1,Matches,Villarreal,2024
158,Luiz Lúcio Reis Júnior,br BRA,GK,24-115,13.2,0,0,0,0,0,0,0,,0,0,0,0,0,0,14,1,Matches,Villarreal,2024
159,Nicolas Pépé,ci CIV,"FW,MF",29-345,13.6,18,8,8,6,4,5,12,41.7,7,10,1,9,5,23,10,0,Matches,Villarreal,2024
160,Willy Kambwala,fr FRA,DF,20-257,10.4,13,8,10,2,1,6,7,85.7,1,7,5,2,8,21,44,1,Matches,Villarreal,2024
161,Eric Bailly,ci CIV,DF,31-027,6.9,12,4,6,6,0,3,4,75.0,1,12,6,6,6,18,29,0,Matches,Villarreal,2024
162,Ilias Akhomach,ma MAR,"MF,FW",21-023,6.5,12,7,4,4,4,6,12,50.0,6,8,0,8,3,15,13,0,Matches,Villarreal,2024
163,Gerard Moreno,es ESP,FW,33-032,7.2,7,4,3,2,2,3,11,27.3,8,0,0,0,2,9,6,0,Matches,Villarreal,2024
164,Denis Suárez,es ESP,MF,31-123,5.9,9,7,7,1,1,4,9,44.4,5,4,1,3,1,10,3,0,Matches,Villarreal,2024
165,Pau Navarro,es ESP,DF,20-014,7.2,19,14,11,6,2,16,28,57.1,12,11,5,6,3,22,30,0,Matches,Villarreal,2024
166,Tajon Buchanan,ca CAN,MF,26-090,3.3,7,4,5,2,0,5,8,62.5,3,4,0,4,1,8,1,0,Matches,Villarreal,2024
167,Arnaut Danjuma,nl NED,FW,28-098,2.2,2,1,0,1,1,0,1,0.0,1,1,0,1,0,2,0,0,Matches,Villarreal,2024
168,Alfonso Pedraza,es ESP,"DF,MF",29-030,3.1,3,2,2,0,1,2,4,50.0,2,2,1,1,4,7,9,0,Matches,Villarreal,2024
169,Juan Bernat,es ESP,"DF,MF",32-069,2.4,9,7,7,1,1,4,5,80.0,1,3,1,2,1,10,4,0,Matches,Villarreal,2024
170,Ramón Terrats,es ESP,"MF,FW",24-203,1.5,3,3,1,2,0,2,4,50.0,2,3,1,2,2,5,3,0,Matches,Villarreal,2024
171,Pau Cabanes,es ESP,"MF,FW",20-081,1.8,4,4,0,3,1,3,4,75.0,1,5,0,5,3,7,2,1,Matches,Villarreal,2024
172,Arnau Solà,es ESP,MF,22-035,0.1,0,0,0,0,0,0,2,0.0,2,1,1,0,0,0,0,0,Matches,Villarreal,2024
173,Thiago Ojeda,ar ARG,MF,22-117,0.1,0,0,0,0,0,0,0,,0,0,0,0,0,0,1,0,Matches,Villarreal,2024
174,Karl Etta,cm CMR,MF,21-207,0.0,0,0,0,0,0,0,0,,0,0,0,0,0,0,0,0,Matches,Villarreal,2024
175,Vicente Guaita,es ESP,GK,38-119,30.0,0,0,0,0,0,0,0,,0,0,0,0,0,0,20,1,Matches,Celta Vigo,2024
176,Óscar Mingueza,es ESP,"MF,DF",25-361,26.6,34,20,17,12,5,24,60,40.0,36,28,4,24,20,54,40,4,Matches,Celta Vigo,2024
177,Marcos Alonso,es ESP,DF,34-132,27.0,33,20,18,12,3,24,43,55.8,19,22,7,15,32,65,115,4,Matches,Celta Vigo,2024
178,Carl Starfelt,se SWE,DF,29-342,25.2,40,20,25,14,1,18,27,66.7,9,29,21,8,31,71,129,3,Matches,Celta Vigo,2024
179,Fran Beltrán,es ESP,MF,26-095,23.4,42,30,19,18,5,19,48,39.6,29,23,5,18,23,65,29,3,Matches,Celta Vigo,2024
180,Javi Rodríguez,es ESP,DF,21-317,24.4,47,34,31,16,0,30,43,69.8,13,28,9,19,31,78,86,1,Matches,Celta Vigo,2024
181,Borja Iglesias,es ESP,FW,32-112,19.9,10,9,2,5,3,4,14,28.6,10,8,2,6,6,16,6,0,Matches,Celta Vigo,2024
182,Ilaix Moriba,gn GUI,MF,22-110,19.7,58,36,19,26,13,26,46,56.5,20,23,4,19,13,71,26,1,Matches,Celta Vigo,2024
183,Iago Aspas,es ESP,"FW,MF",37-281,17.7,13,8,4,5,4,8,19,42.1,11,16,1,15,7,20,5,0,Matches,Celta Vigo,2024
184,Sergio Carreira,es ESP,"MF,DF",24-208,16.4,27,16,15,6,6,14,24,58.3,10,18,2,16,17,44,35,0,Matches,Celta Vigo,2024
185,Hugo Álvarez,es ESP,"MF,DF",21-311,16.4,23,9,11,10,2,9,17,52.9,8,18,1,17,8,31,28,1,Matches,Celta Vigo,2024
186,Hugo Sotelo,es ESP,MF,21-141,13.9,28,17,8,10,10,13,30,43.3,17,9,1,8,5,33,9,1,Matches,Celta Vigo,2024
187,Pablo Durán,es ESP,"FW,MF",23-349,13.1,14,9,4,7,3,3,12,25.0,9,8,2,6,8,22,9,0,Matches,Celta Vigo,2024
188,Williot Swedberg,se SWE,"FW,MF",21-097,13.0,19,13,6,9,4,11,17,64.7,6,12,1,11,3,22,9,1,Matches,Celta Vigo,2024
189,Alfon,es ESP,"FW,MF",26-005,13.5,6,2,2,2,2,2,10,20.0,8,6,0,6,4,10,5,1,Matches,Celta Vigo,2024
190,Carlos Dominguez,es ESP,DF,24-087,10.0,20,11,12,8,0,14,19,73.7,5,9,6,3,8,28,51,1,Matches,Celta Vigo,2024
191,Jonathan Bamba,ci CIV,"FW,MF",29-044,9.0,12,7,4,6,2,5,12,41.7,7,6,0,6,5,17,6,0,Matches,Celta Vigo,2024
192,Damián Rodríguez,es ESP,MF,22-053,9.8,14,9,3,10,1,6,16,37.5,10,6,1,5,6,20,11,0,Matches,Celta Vigo,2024
193,Javier Manquillo,es ESP,DF,31-004,5.7,7,5,4,3,0,2,10,20.0,8,5,3,2,7,14,14,0,Matches,Celta Vigo,2024
194,Anastasios Douvikas,gr GRE,FW,25-280,7.8,9,4,2,6,1,3,6,50.0,3,5,2,3,3,12,6,0,Matches,Celta Vigo,2024
195,Jailson Siqueira,br BRA,"DF,MF",29-244,6.8,13,11,9,3,1,9,11,81.8,2,6,4,2,9,22,28,1,Matches,Celta Vigo,2024
196,Fer López,,"FW,MF",,5.9,7,3,1,4,2,0,6,0.0,6,8,0,8,2,9,7,0,Matches,Celta Vigo,2024
197,Yoel Lago,es ESP,DF,21-045,4.3,7,4,4,2,1,3,4,75.0,1,3,2,1,4,11,14,0,Matches,Celta Vigo,2024
198,Iván Villar,es ESP,GK,27-304,4.0,0,0,0,0,0,0,0,,0,0,0,0,0,0,3,0,Matches,Celta Vigo,2024
199,Iker Losada,es ESP,"FW,MF",23-281,3.8,3,3,0,1,2,1,5,20.0,4,3,0,3,1,4,7,0,Matches,Celta Vigo,2024
200,Franco Cervi,ar ARG,"FW,MF",30-348,2.9,8,3,2,6,0,3,7,42.9,4,4,0,4,8,16,6,0,Matches,Celta Vigo,2024
201,Mihailo Ristić,rs SRB,"MF,DF",29-190,2.7,3,3,2,1,0,1,3,33.3,2,0,0,0,1,4,6,0,Matches,Celta Vigo,2024
202,Luca de la Torre,us USA,MF,26-351,0.0,0,0,0,0,0,0,0,,0,0,0,0,0,0,0,0,Matches,Celta Vigo,2024
203,Joseph Aidoo,gh GHA,DF,29-222,0.0,1,0,1,0,0,0,0,,0,0,0,0,0,1,0,0,Matches,Celta Vigo,2024
204,Tadeo Allende,ar ARG,FW,26-078,0.0,0,0,0,0,0,0,0,,0,0,0,0,0,0,0,0,Matches,Celta Vigo,2024
205,Florian Lejeune,fr FRA,DF,33-354,32.9,43,26,28,13,2,21,39,53.8,18,35,29,6,30,73,162,1,Matches,Rayo Vallecano,2024
206,Andrei Ratiu,ro ROU,DF,26-323,30.2,65,37,40,17,8,39,64,60.9,25,36,3,33,26,91,68,2,Matches,Rayo Vallecano,2024
207,Augusto Batalla,ar ARG,GK,29-009,28.0,4,2,4,0,0,4,6,66.7,2,0,0,0,0,4,11,4,Matches,Rayo Vallecano,2024
208,Jorge de Frutos,es ESP,"FW,MF",28-078,24.7,35,19,15,13,7,12,40,30.0,28,20,0,20,17,52,20,1,Matches,Rayo Vallecano,2024
209,Pep Chavarría,es ESP,"DF,FW",27-029,25.4,39,30,25,13,1,24,38,63.2,14,31,8,23,26,65,98,1,Matches,Rayo Vallecano,2024
210,Álvaro García,es ESP,"FW,MF",32-194,25.2,31,22,19,8,4,12,28,42.9,16,30,0,30,30,61,39,1,Matches,Rayo Vallecano,2024
211,Abdul Mumin,gh GHA,DF,26-337,22.4,37,25,30,7,0,17,27,63.0,10,40,29,11,23,60,125,0,Matches,Rayo Vallecano,2024
212,Pathé Ciss,sn SEN,"MF,DF",31-054,21.0,45,22,23,21,1,20,40,50.0,20,28,7,21,34,79,57,3,Matches,Rayo Vallecano,2024
213,Isaac Palazón Camacho,es ESP,"MF,FW",30-133,20.0,22,17,10,6,6,8,31,25.8,23,18,1,17,8,30,12,1,Matches,Rayo Vallecano,2024
214,Unai López,es ESP,MF,29-191,16.8,24,16,11,8,5,12,28,42.9,16,14,3,11,20,44,19,0,Matches,Rayo Vallecano,2024
215,Óscar Valentín,es ESP,MF,30-262,18.6,53,40,21,19,13,32,68,47.1,36,33,6,27,21,74,48,2,Matches,Rayo Vallecano,2024
216,Adri Embarba,es ESP,"FW,MF",33-002,16.5,37,17,14,16,7,16,42,38.1,26,17,1,16,12,49,13,1,Matches,Rayo Vallecano,2024
217,Randy Nteka,ao ANG,FW,27-154,12.5,16,5,3,9,4,5,12,41.7,7,13,2,11,4,20,20,0,Matches,Rayo Vallecano,2024
218,Sergio Camello,es ESP,FW,24-088,12.6,9,3,2,5,2,4,6,66.7,2,8,1,7,4,13,16,0,Matches,Rayo Vallecano,2024
219,Pedro Díaz,es ESP,MF,26-338,11.5,21,13,6,13,2,12,35,34.3,23,13,0,13,6,27,6,1,Matches,Rayo Vallecano,2024
220,Iván Balliu,al ALB,DF,33-128,10.0,12,9,4,5,3,4,12,33.3,8,13,3,10,10,22,30,0,Matches,Rayo Vallecano,2024
221,Aridane Hernández,es ESP,DF,36-047,8.4,9,7,5,4,0,2,4,50.0,2,7,5,2,3,12,69,2,Matches,Rayo Vallecano,2024
222,Alfonso Espino,uy URU,DF,33-124,8.2,37,20,29,6,2,23,42,54.8,19,14,6,8,10,47,28,1,Matches,Rayo Vallecano,2024
223,Gerard Gumbau,es ESP,MF,30-142,8.6,16,12,8,6,2,7,15,46.7,8,10,4,6,5,21,11,0,Matches,Rayo Vallecano,2024
224,Cárdenas,es ESP,GK,28-042,6.0,0,0,0,0,0,0,0,,0,0,0,0,0,0,3,0,Matches,Rayo Vallecano,2024
225,Óscar Trejo,ar ARG,MF,37-013,5.4,7,5,1,4,2,3,9,33.3,6,8,0,8,4,11,5,0,Matches,Rayo Vallecano,2024
226,Sergi Guardiola,es ESP,FW,33-345,4.0,5,3,0,5,0,2,3,66.7,1,1,0,1,1,6,2,0,Matches,Rayo Vallecano,2024
227,James Rodríguez,co COL,"MF,FW",33-301,1.6,3,2,1,2,0,0,2,0.0,2,2,0,2,1,4,0,0,Matches,Rayo Vallecano,2024
228,Pelayo Fernandez,es ESP,DF,22-010,1.0,0,0,0,0,0,0,0,,0,0,0,0,1,1,8,0,Matches,Rayo Vallecano,2024
229,Etienne Eto'o,cm CMR,FW,22-264,0.4,0,0,0,0,0,0,1,0.0,1,0,0,0,0,0,1,0,Matches,Rayo Vallecano,2024
230,Raúl de Tomás,es ESP,"DF,FW",30-204,0.2,2,2,1,0,1,0,0,,0,0,0,0,0,2,0,0,Matches,Rayo Vallecano,2024
231,Sergio Herrera,es ESP,GK,31-338,33.0,2,1,2,0,0,2,5,40.0,3,1,0,1,0,2,27,1,Matches,Osasuna,2024
232,Jesús Areso,es ESP,DF,25-311,30.2,45,34,29,11,5,35,51,68.6,16,25,4,21,8,53,79,0,Matches,Osasuna,2024
233,Catena,es ESP,DF,30-193,30.2,43,25,32,9,2,25,41,61.0,16,35,21,14,31,74,193,1,Matches,Osasuna,2024
234,Lucas Torró,es ESP,MF,30-294,29.4,69,39,30,35,4,35,62,56.5,27,33,9,24,43,112,55,3,Matches,Osasuna,2024
235,Aimar Oroz,es ESP,"MF,FW",23-163,29.0,32,18,15,11,6,14,44,31.8,30,27,2,25,18,50,7,0,Matches,Osasuna,2024
236,Ante Budimir,hr CRO,FW,33-291,29.1,20,9,3,11,6,3,12,25.0,9,18,4,14,2,22,19,0,Matches,Osasuna,2024
237,Enzo Boyomo,cm CMR,DF,23-214,29.2,61,37,42,15,4,26,33,78.8,7,33,19,14,36,97,114,3,Matches,Osasuna,2024
238,Rubén García,es ESP,"FW,MF",31-299,24.5,46,29,17,19,10,23,51,45.1,28,32,2,30,14,60,30,1,Matches,Osasuna,2024
239,Jon Moncayola,es ESP,MF,26-361,22.9,68,40,28,32,8,30,59,50.8,29,34,3,31,11,79,19,0,Matches,Osasuna,2024
240,Abel,es ESP,DF,24-261,22.4,59,35,28,24,7,37,59,62.7,22,28,4,24,18,77,61,2,Matches,Osasuna,2024
241,Bryan Zaragoza,es ESP,"FW,MF",24-014,16.9,13,9,8,4,1,6,20,30.0,14,9,0,9,1,14,8,0,Matches,Osasuna,2024
242,Jorge Herrando,es ESP,DF,24-070,15.2,17,11,9,5,3,9,15,60.0,6,20,14,6,12,29,65,2,Matches,Osasuna,2024
243,Juan Cruz Armada,es ESP,DF,32-285,13.0,20,10,9,10,1,11,19,57.9,8,14,4,10,8,28,44,0,Matches,Osasuna,2024
244,Pablo Ibáñez,es ESP,MF,26-231,11.4,18,9,6,11,1,9,37,24.3,28,18,6,12,14,32,19,0,Matches,Osasuna,2024
245,Moi Gómez,es ESP,"MF,FW",30-320,8.8,13,9,4,7,2,4,8,50.0,4,5,2,3,5,18,7,1,Matches,Osasuna,2024
246,Rubén Peña,es ESP,"FW,DF",33-295,7.6,9,3,3,2,4,3,18,16.7,15,10,0,10,5,14,11,0,Matches,Osasuna,2024
247,Raúl,es ESP,"FW,MF",24-187,7.7,11,6,3,5,3,4,9,44.4,5,4,0,4,0,11,5,0,Matches,Osasuna,2024
248,Iker Muñoz,es ESP,MF,22-185,5.6,5,2,3,2,0,3,8,37.5,5,7,1,6,4,9,10,1,Matches,Osasuna,2024
249,Kike Barja,es ESP,"FW,MF",28-038,2.9,5,4,1,3,1,2,3,66.7,1,5,0,5,3,8,4,0,Matches,Osasuna,2024
250,Nacho Vidal,es ESP,DF,30-105,1.4,2,0,0,1,1,1,4,25.0,3,1,0,1,0,2,6,0,Matches,Osasuna,2024
251,José Arnaiz,es ESP,"MF,FW",30-024,1.4,6,4,3,2,1,4,7,57.1,3,2,0,2,3,9,1,0,Matches,Osasuna,2024
252,Aitor Fernández,es ESP,GK,34-006,1.0,0,0,0,0,0,0,0,,0,0,0,0,0,0,2,0,Matches,Osasuna,2024
253,Unai García,es ESP,DF,33-095,0.7,0,0,0,0,0,0,0,,0,1,0,1,0,0,1,0,Matches,Osasuna,2024
254,Iker Benito,es ESP,"FW,MF",22-272,0.4,0,0,0,0,0,0,1,0.0,1,0,0,0,1,1,2,0,Matches,Osasuna,2024
255,Javi Martínez,es ESP,MF,25-138,0.1,0,0,0,0,0,0,0,,0,0,0,0,0,0,0,0,Matches,Osasuna,2024
256,Antonio Raillo,es ESP,DF,33-213,31.6,29,17,16,10,3,14,18,77.8,4,39,31,8,27,56,193,1,Matches,Mallorca,2024
257,Sergi Darder,es ESP,"MF,FW",31-138,26.6,37,23,15,14,8,15,39,38.5,24,18,1,17,14,51,20,1,Matches,Mallorca,2024
258,Johan Mojica,co COL,DF,32-261,28.3,33,22,25,5,3,18,37,48.6,19,11,5,6,25,58,76,2,Matches,Mallorca,2024
259,Dominik Greif,sk SVK,GK,28-033,28.0,0,0,0,0,0,0,0,,0,0,0,0,0,0,9,1,Matches,Mallorca,2024
260,Martin Valjent,sk SVK,DF,29-149,27.7,27,18,20,6,1,13,16,81.3,3,28,18,10,17,44,173,1,Matches,Mallorca,2024
261,Samu Costa,pt POR,MF,24-163,25.6,77,38,38,37,2,27,66,40.9,39,40,12,28,29,106,75,1,Matches,Mallorca,2024
262,Pablo Maffeo,es ESP,DF,27-301,24.5,56,37,41,12,3,32,43,74.4,11,31,11,20,24,80,90,1,Matches,Mallorca,2024
263,Dani Rodríguez,es ESP,"MF,FW",36-337,21.8,44,27,14,20,10,13,26,50.0,13,20,2,18,12,56,22,0,Matches,Mallorca,2024
264,Vedat Muriqi,xk KVX,FW,31-015,19.6,6,4,3,2,1,3,6,50.0,3,5,1,4,7,13,33,0,Matches,Mallorca,2024
265,Cyle Larin,ca CAN,FW,30-022,18.0,11,5,1,5,5,2,7,28.6,5,12,3,9,1,12,14,0,Matches,Mallorca,2024
266,Omar Mascarell,gq EQG,MF,32-096,19.1,24,13,11,12,1,12,28,42.9,16,27,18,9,45,69,49,2,Matches,Mallorca,2024
267,Copete,es ESP,DF,25-211,16.0,27,15,16,10,1,10,11,90.9,1,23,15,8,17,44,116,2,Matches,Mallorca,2024
268,Manu Morlanes,es ESP,MF,26-117,14.4,43,27,18,20,5,18,30,60.0,12,18,7,11,24,67,16,0,Matches,Mallorca,2024
269,Roberto Navarro,es ESP,"MF,FW",23-027,14.2,29,22,14,11,4,9,19,47.4,10,18,0,18,19,48,12,0,Matches,Mallorca,2024
270,Takuma Asano,jp JPN,"FW,MF",30-180,11.0,13,9,5,7,1,6,11,54.5,5,7,0,7,5,18,8,0,Matches,Mallorca,2024
271,Antonio Sánchez,es ESP,"MF,DF",28-128,13.6,27,16,15,8,4,14,29,48.3,15,12,2,10,17,44,29,0,Matches,Mallorca,2024
272,Leo Román,es ESP,GK,24-307,6.0,0,0,0,0,0,0,0,,0,0,0,0,0,0,4,0,Matches,Mallorca,2024
273,Mateu Morey,es ESP,DF,25-068,5.5,14,13,8,4,2,10,17,58.8,7,8,0,8,9,23,15,1,Matches,Mallorca,2024
274,Toni Lato,es ESP,DF,27-169,5.1,16,10,6,4,6,6,9,66.7,3,6,2,4,4,20,27,0,Matches,Mallorca,2024
275,Abdón Prats,es ESP,"FW,MF",32-153,5.1,2,1,1,1,0,1,2,50.0,1,2,1,1,1,3,5,0,Matches,Mallorca,2024
276,Marc Domenech,es ESP,"FW,MF",19-128,2.3,3,3,1,1,1,2,4,50.0,2,2,0,2,0,3,0,0,Matches,Mallorca,2024
277,Valery Fernández,es ESP,"MF,FW",25-167,3.3,8,7,3,2,3,5,7,71.4,2,3,1,2,0,8,1,0,Matches,Mallorca,2024
278,Chiquinho,pt POR,"MF,FW",25-093,1.6,1,0,0,1,0,0,7,0.0,7,3,0,3,2,3,0,0,Matches,Mallorca,2024
279,Siebe Van Der Heyden,be BEL,"DF,MF",26-344,1.1,1,1,0,1,0,0,0,,0,1,0,1,2,3,3,0,Matches,Mallorca,2024
280,David López,es ESP,DF,22-095,0.9,1,1,1,0,0,1,1,100.0,0,0,0,0,1,2,3,0,Matches,Mallorca,2024
281,Javier Llabrés,es ESP,FW,22-240,0.6,0,0,0,0,0,0,0,,0,1,0,1,0,0,0,0,Matches,Mallorca,2024
282,Jan Salas,es ESP,MF,19-272,0.3,2,1,1,1,0,1,1,100.0,0,0,0,0,0,2,0,0,Matches,Mallorca,2024
283,Daniel Luna,co COL,MF,22-002,0.2,0,0,0,0,0,0,0,,0,1,0,1,0,0,0,0,Matches,Mallorca,2024
284,Álex Remiro,es ESP,GK,30-046,33.0,1,0,1,0,0,1,2,50.0,1,0,0,0,0,1,17,4,Matches,Real Sociedad,2024
285,Martín Zubimendi,es ESP,MF,26-096,29.9,70,37,30,29,11,28,44,63.6,16,39,16,23,39,109,74,3,Matches,Real Sociedad,2024
286,Sergio Gómez,es ESP,"MF,DF",24-247,28.2,68,38,27,29,12,28,53,52.8,25,40,2,38,17,85,28,2,Matches,Real Sociedad,2024
287,Jon Aramburu,ve VEN,DF,22-290,24.7,91,65,52,29,10,60,91,65.9,31,35,8,27,28,119,92,0,Matches,Real Sociedad,2024
288,Igor Zubeldia,es ESP,DF,28-040,22.7,32,21,21,9,2,14,25,56.0,11,31,18,13,25,57,91,2,Matches,Real Sociedad,2024
289,Mikel Oyarzabal,es ESP,"FW,MF",28-018,22.3,19,11,7,7,5,9,18,50.0,9,15,1,14,4,23,14,0,Matches,Real Sociedad,2024
290,Takefusa Kubo,jp JPN,"MF,FW",23-339,22.9,29,18,10,11,8,16,37,43.2,21,32,1,31,13,42,13,1,Matches,Real Sociedad,2024
291,Nayef Aguerd,ma MAR,DF,29-040,19.6,30,24,17,12,1,12,18,66.7,6,21,15,6,13,43,91,0,Matches,Real Sociedad,2024
292,Javi López,es ESP,DF,23-045,19.5,38,23,22,12,4,21,35,60.0,14,20,7,13,8,46,55,1,Matches,Real Sociedad,2024
293,Luka Sučić,hr CRO,MF,22-243,17.8,24,17,7,12,5,9,24,37.5,15,27,2,25,13,37,15,1,Matches,Real Sociedad,2024
294,Brais Méndez,es ESP,MF,28-122,15.5,21,13,6,11,4,8,22,36.4,14,13,1,12,7,28,16,1,Matches,Real Sociedad,2024
295,Aritz Elustondo,es ESP,DF,31-042,13.2,17,9,12,3,2,9,17,52.9,8,16,12,4,9,26,81,0,Matches,Real Sociedad,2024
296,Ander Barrenetxea,es ESP,"MF,FW",23-133,12.3,23,16,7,11,5,5,20,25.0,15,15,0,15,10,33,15,1,Matches,Real Sociedad,2024
297,Sheraldo Becker,sr SUR,"FW,MF",30-089,11.1,3,2,0,3,0,0,2,0.0,2,4,0,4,1,4,10,0,Matches,Real Sociedad,2024
298,Aihen Muñoz,es ESP,DF,27-266,10.3,23,12,13,8,2,13,27,48.1,14,10,6,4,13,36,45,0,Matches,Real Sociedad,2024
299,Pablo Marín,es ESP,MF,21-310,10.6,21,14,5,11,5,7,15,46.7,8,12,3,9,4,25,13,0,Matches,Real Sociedad,2024
300,Beñat Turrientes,es ESP,MF,23-098,9.1,13,5,4,8,1,4,13,30.8,9,14,2,12,5,18,12,0,Matches,Real Sociedad,2024
301,Orri Steinn Óskarsson,is ISL,FW,20-253,10.5,6,6,2,1,3,2,8,25.0,6,10,1,9,2,8,11,0,Matches,Real Sociedad,2024
302,Jon Pacheco,es ESP,DF,24-121,8.5,13,9,10,3,0,8,10,80.0,2,8,6,2,8,21,45,2,Matches,Real Sociedad,2024
303,Olasagasti,es ESP,MF,24-266,8.8,19,9,5,9,5,7,17,41.2,10,8,2,6,13,32,10,0,Matches,Real Sociedad,2024
304,Hamari Traoré,ml MLI,DF,33-102,6.4,18,11,9,7,2,14,19,73.7,5,4,1,3,8,26,18,0,Matches,Real Sociedad,2024
305,Jon Martin,es ESP,DF,19-128,8.0,9,7,6,2,1,6,9,66.7,3,11,7,4,7,16,56,0,Matches,Real Sociedad,2024
306,Umar Sadiq,ng NGA,FW,28-096,2.5,2,1,1,1,0,1,2,50.0,1,3,1,2,1,3,2,0,Matches,Real Sociedad,2024
307,Unai Marrero,es ESP,GK,23-212,1.0,0,0,0,0,0,0,0,,0,0,0,0,0,0,1,0,Matches,Real Sociedad,2024
308,Arsen Zakharyan,ru RUS,"MF,FW",21-348,0.8,1,1,1,0,0,1,1,100.0,0,1,1,0,1,2,0,0,Matches,Real Sociedad,2024
309,Urko González,es ESP,MF,24-050,0.5,0,0,0,0,0,0,0,,0,1,1,0,0,0,0,0,Matches,Real Sociedad,2024
310,Arkaitz Mariezkurrena,es ESP,"MF,FW",20-034,1.2,1,0,1,0,0,0,3,0.0,3,1,0,1,1,2,3,0,Matches,Real Sociedad,2024
311,Álvaro Odriozola,es ESP,DF,29-146,0.5,1,1,1,0,0,0,0,,0,0,0,0,0,1,1,0,Matches,Real Sociedad,2024
312,Daniel Díaz,es ESP,MF,18-321,0.1,1,1,1,0,0,0,0,,0,1,0,1,0,1,0,0,Matches,Real Sociedad,2024
313,Luken Beitia,es ESP,DF,20-313,0.1,1,1,1,0,0,1,1,100.0,0,0,0,0,0,1,2,0,Matches,Real Sociedad,2024
314,Jon Magunazelaia,es ESP,MF,24-300,0.1,1,1,1,0,0,0,0,,0,0,0,0,0,1,0,0,Matches,Real Sociedad,2024
315,Cristhian Mosquera,es ESP,DF,20-316,32.9,43,29,33,9,1,24,33,72.7,9,32,22,10,33,76,113,4,Matches,Valencia,2024
316,Diego López,es ESP,"MF,FW",22-361,27.7,28,17,9,15,4,16,45,35.6,29,24,0,24,13,41,13,0,Matches,Valencia,2024
317,Giorgi Mamardashvili,ge GEO,GK,24-222,30.0,2,2,2,0,0,2,3,66.7,1,0,0,0,1,3,13,3,Matches,Valencia,2024
318,César Tárrega,es ESP,DF,23-072,29.6,44,33,28,13,3,18,28,64.3,10,35,18,17,20,64,205,2,Matches,Valencia,2024
319,Luis Rioja,es ESP,"MF,FW",31-205,28.6,31,20,13,12,6,13,39,33.3,26,29,1,28,22,53,41,0,Matches,Valencia,2024
320,Javier Guerra,es ESP,MF,22-128,25.9,45,23,16,18,11,22,47,46.8,25,12,1,11,19,64,40,2,Matches,Valencia,2024
321,Dimitri Foulquier,fr FRA,DF,32-047,24.9,48,31,29,13,6,24,36,66.7,12,21,5,16,16,64,84,1,Matches,Valencia,2024
322,Hugo Duro,es ESP,FW,25-180,21.8,12,7,4,7,1,4,11,36.4,7,11,2,9,10,22,10,0,Matches,Valencia,2024
323,Enzo Barrenechea,ar ARG,MF,23-352,21.2,52,29,21,25,6,30,42,71.4,12,25,7,18,25,77,45,1,Matches,Valencia,2024
324,Domingos André Ribeiro Almeida,pt POR,"MF,FW",24-344,19.5,44,28,16,19,9,14,34,41.2,20,18,2,16,8,52,14,1,Matches,Valencia,2024
325,José Luis Gayà,es ESP,DF,29-349,17.3,50,36,34,13,3,39,55,70.9,16,14,2,12,20,70,52,0,Matches,Valencia,2024
326,José Luis García Vayá,es ESP,MF,26-271,17.4,38,21,20,12,6,16,28,57.1,12,20,6,14,15,53,32,0,Matches,Valencia,2024
327,Yarek Gasiorowski,es ESP,DF,20-117,10.5,19,16,16,3,0,9,13,69.2,4,17,6,11,26,45,60,0,Matches,Valencia,2024
328,Jesus Vazquez,es ESP,DF,22-127,9.1,20,16,11,7,2,8,17,47.1,9,15,5,10,7,27,27,0,Matches,Valencia,2024
329,Thierry Correia,pt POR,DF,26-061,8.5,27,18,19,5,3,13,23,56.5,10,10,1,9,4,31,18,0,Matches,Valencia,2024
330,Umar Sadiq,ng NGA,FW,28-096,7.5,9,5,2,5,2,4,6,66.7,2,5,0,5,1,10,6,0,Matches,Valencia,2024
331,Dani Gómez,es ESP,FW,26-283,5.9,3,2,0,0,3,0,0,,0,1,0,1,2,5,4,0,Matches,Valencia,2024
332,Rafa Mir,es ESP,"FW,MF",27-325,6.6,10,6,6,4,0,2,8,25.0,6,3,0,3,4,14,8,0,Matches,Valencia,2024
333,Mouctar Diakhaby,gn GUI,DF,28-141,4.1,5,1,5,0,0,3,5,60.0,2,6,5,1,3,8,32,0,Matches,Valencia,2024
334,Hugo Guillamón,es ESP,MF,25-098,4.0,11,8,1,9,1,9,10,90.0,1,4,1,3,5,16,9,1,Matches,Valencia,2024
335,Stole Dimitrievski,mk MKD,GK,31-135,4.0,0,0,0,0,0,0,0,,0,0,0,0,0,0,3,1,Matches,Valencia,2024
336,Francisco Perez,es ESP,"MF,FW",22-242,5.1,12,11,5,6,1,9,15,60.0,6,8,1,7,3,15,6,0,Matches,Valencia,2024
337,Sergi Canós,es ESP,"MF,FW",28-096,4.0,11,7,3,4,4,4,10,40.0,6,5,1,4,5,16,4,0,Matches,Valencia,2024
338,Ivan Jaime Pajuelo,es ESP,MF,24-225,2.1,4,2,1,1,2,2,3,66.7,1,1,0,1,2,6,0,0,Matches,Valencia,2024
339,Germán Valera,es ESP,MF,23-054,1.6,1,1,1,0,0,0,1,0.0,1,2,0,2,4,5,2,1,Matches,Valencia,2024
340,Max Aarons,eng ENG,"DF,MF",25-125,1.2,3,3,2,1,0,3,3,100.0,0,1,0,1,0,3,3,0,Matches,Valencia,2024
341,Maximiliano Caufriez,be BEL,DF,28-082,1.0,1,1,1,0,0,1,1,100.0,0,2,1,1,1,2,4,0,Matches,Valencia,2024
342,Rodrigo Abajas,es ESP,DF,21-362,0.7,3,2,2,1,0,3,3,100.0,0,1,0,1,1,4,0,0,Matches,Valencia,2024
343,Martín Tejón,es ESP,"MF,DF",21-027,0.5,2,0,0,2,0,1,2,50.0,1,0,0,0,0,2,0,0,Matches,Valencia,2024
344,Iker Córdoba,es ESP,DF,19-179,0.2,0,0,0,0,0,0,0,,0,0,0,0,0,0,1,0,Matches,Valencia,2024
345,David Otorbi,es ESP,MF,17-205,0.2,0,0,0,0,0,0,0,,0,1,0,1,0,0,0,0,Matches,Valencia,2024
346,Alberto Marí,es ESP,FW,23-302,0.1,0,0,0,0,0,0,0,,0,0,0,0,0,0,0,0,Matches,Valencia,2024
347,David Soria,es ESP,GK,32-035,34.0,4,4,4,0,0,4,5,80.0,1,0,0,0,1,5,17,2,Matches,Getafe,2024
348,Omar Alderete,py PAR,DF,28-134,30.4,41,27,29,10,2,20,30,66.7,10,33,21,12,36,77,207,1,Matches,Getafe,2024
349,Djené,tg TOG,"DF,MF",33-129,27.3,25,13,12,11,2,12,31,38.7,19,18,8,10,21,46,104,3,Matches,Getafe,2024
350,Luis Milla,es ESP,MF,30-214,28.9,52,34,27,20,5,29,62,46.8,33,23,0,23,21,73,27,2,Matches,Getafe,2024
351,Iglesias,es ESP,DF,26-310,28.3,75,46,39,30,6,43,82,52.4,39,43,7,36,41,116,123,1,Matches,Getafe,2024
352,Diego Rico,es ESP,DF,32-075,27.3,74,45,44,27,3,42,77,54.5,35,37,3,34,31,105,90,2,Matches,Getafe,2024
353,Mauro Arambarri,uy URU,MF,29-221,26.9,45,26,9,31,5,21,44,47.7,23,33,6,27,13,58,41,0,Matches,Getafe,2024
354,Chrisantus Uche,ng NGA,"FW,MF",21-355,24.8,28,17,6,16,6,6,15,40.0,9,18,2,16,9,37,17,0,Matches,Getafe,2024
355,Domingos Duarte,pt POR,DF,30-060,17.0,23,11,18,4,1,13,17,76.5,4,24,14,10,13,36,124,1,Matches,Getafe,2024
356,Carles Pérez,es ESP,"MF,FW",27-082,15.9,33,23,11,14,8,21,48,43.8,27,19,2,17,6,39,22,0,Matches,Getafe,2024
357,Bertuğ Yıldırım,tr TUR,FW,22-301,11.6,10,5,0,7,3,2,7,28.6,5,12,2,10,1,11,16,0,Matches,Getafe,2024
358,Alex Sola,es ESP,"MF,FW",25-334,11.4,21,14,9,12,0,9,25,36.0,16,8,0,8,7,28,11,1,Matches,Getafe,2024
359,Ramón Terrats,es ESP,"MF,FW",24-203,10.1,14,6,7,2,5,7,24,29.2,17,7,1,6,4,18,12,0,Matches,Getafe,2024
360,Coba da Costa,es ESP,"MF,FW",22-287,9.9,27,12,9,15,3,12,24,50.0,12,21,0,21,7,34,7,0,Matches,Getafe,2024
361,Juan Berrocal,es ESP,DF,26-005,10.6,14,7,10,4,0,10,13,76.9,3,3,2,1,13,27,50,0,Matches,Getafe,2024
362,Allan Nyom,cm CMR,"DF,MF",36-364,7.7,13,7,5,7,1,10,12,83.3,2,4,2,2,2,15,18,0,Matches,Getafe,2024
363,Juanmi,es ESP,"FW,MF",31-354,7.4,14,11,4,7,3,6,16,37.5,10,6,0,6,2,16,3,0,Matches,Getafe,2024
364,Juan Bernat,es ESP,"MF,DF",32-069,7.0,16,12,8,5,3,6,11,54.5,5,8,3,5,2,18,8,0,Matches,Getafe,2024
365,Álvaro Rodríguez,uy URU,FW,20-299,7.9,9,6,0,6,3,4,8,50.0,4,21,0,21,3,12,12,0,Matches,Getafe,2024
366,Carles Aleñá,es ESP,"MF,FW",27-124,5.0,6,3,2,3,1,4,13,30.8,9,9,1,8,0,6,7,0,Matches,Getafe,2024
367,Borja Mayoral,es ESP,FW,28-034,9.3,2,2,1,1,0,1,5,20.0,4,3,0,3,0,2,6,0,Matches,Getafe,2024
368,Jesús Santiago,es ESP,MF,20-349,3.6,12,7,6,6,0,5,9,55.6,4,5,2,3,1,13,3,0,Matches,Getafe,2024
369,Nabil Aberdin,fr FRA,MF,22-259,2.9,6,4,3,3,0,1,1,100.0,0,3,0,3,0,6,5,0,Matches,Getafe,2024
370,Peter González,do DOM,"MF,FW",22-288,4.4,9,5,1,4,4,4,7,57.1,3,6,0,6,1,10,5,0,Matches,Getafe,2024
371,Abdoulaye Keita,es ESP,"FW,MF",22-250,1.1,2,2,0,1,1,2,4,50.0,2,1,0,1,0,2,3,0,Matches,Getafe,2024
372,Alberto Risco,es ESP,"MF,FW",19-252,0.8,4,4,2,0,2,1,6,16.7,5,2,0,2,0,4,0,0,Matches,Getafe,2024
373,John Joe,ie IRL,"MF,FW",21-197,0.5,0,0,0,0,0,0,0,,0,1,1,0,0,0,1,0,Matches,Getafe,2024
374,Gorka Rivera Alonso,es ESP,"DF,MF",20-281,0.2,2,0,0,2,0,2,2,100.0,0,0,0,0,0,2,0,0,Matches,Getafe,2024
375,Ismael Bekhoucha,ma MAR,"DF,MF",20-170,0.1,0,0,0,0,0,0,0,,0,0,0,0,2,2,0,0,Matches,Getafe,2024
376,David Argüelles,es ESP,MF,23-128,0.1,0,0,0,0,0,0,0,,0,2,0,2,0,0,0,0,Matches,Getafe,2024
377,Joan García,es ESP,GK,24-005,34.0,0,0,0,0,0,0,1,0.0,1,1,0,1,0,0,18,4,Matches,Espanyol,2024
378,Omar El Hilali,ma MAR,DF,21-239,32.1,106,76,77,24,5,60,90,66.7,30,48,12,36,43,149,140,2,Matches,Espanyol,2024
379,Marash Kumbulla,al ALB,DF,25-090,30.0,49,24,34,13,2,24,39,61.5,15,44,33,11,31,80,207,2,Matches,Espanyol,2024
380,Javi Puado,es ESP,"FW,MF",26-349,29.5,19,15,11,4,4,8,15,53.3,7,14,2,12,5,24,19,0,Matches,Espanyol,2024
381,Leandro Cabrera,uy URU,DF,33-326,29.0,37,21,26,8,3,17,30,56.7,13,34,24,10,28,65,188,2,Matches,Espanyol,2024
382,Alex Král,cz CZE,MF,26-355,29.2,54,36,28,23,3,16,29,55.2,13,33,14,19,27,81,49,2,Matches,Espanyol,2024
383,Carlos Romero,es ESP,DF,23-192,24.4,59,37,43,13,3,36,68,52.9,32,43,14,29,23,82,91,1,Matches,Espanyol,2024
384,Jofre,es ESP,"MF,FW",23-326,22.4,21,15,13,5,3,12,21,57.1,9,13,0,13,15,36,28,0,Matches,Espanyol,2024
385,Pol Lozano,es ESP,MF,25-215,19.8,50,33,20,25,5,24,54,44.4,30,28,5,23,21,71,29,0,Matches,Espanyol,2024
386,Roberto Férnandez,es ESP,FW,22-310,13.1,4,4,2,1,1,0,3,0.0,3,7,1,6,3,7,21,0,Matches,Espanyol,2024
387,Álvaro Tejero,es ESP,"MF,DF",28-293,13.2,12,4,5,6,1,5,20,25.0,15,9,1,8,12,24,34,1,Matches,Espanyol,2024
388,Urko González,es ESP,MF,24-050,11.5,36,20,21,14,1,22,31,71.0,9,22,10,12,7,43,29,0,Matches,Espanyol,2024
389,Brian Oliván,es ESP,DF,31-038,11.3,13,10,7,6,0,4,13,30.8,9,6,2,4,10,23,23,0,Matches,Espanyol,2024
390,Antoniu,es ESP,"MF,FW",22-246,9.8,20,9,8,8,4,9,18,50.0,9,13,2,11,7,27,10,1,Matches,Espanyol,2024
391,Alejo Véliz,ar ARG,FW,21-232,11.2,1,1,0,1,0,1,6,16.7,5,11,2,9,4,5,21,1,Matches,Espanyol,2024
392,Edu Expósito,es ESP,MF,28-281,8.0,16,9,5,11,0,6,18,33.3,12,3,0,3,10,26,16,2,Matches,Espanyol,2024
393,José Gragera,es ESP,MF,24-160,6.3,25,16,11,14,0,9,17,52.9,8,9,1,8,5,30,13,0,Matches,Espanyol,2024
394,Sergi Gómez,es ESP,DF,33-042,7.2,8,5,7,1,0,2,3,66.7,1,12,8,4,7,15,36,0,Matches,Espanyol,2024
395,Walid Cheddira,ma MAR,FW,27-107,6.8,5,0,1,1,3,0,1,0.0,1,4,0,4,1,6,6,0,Matches,Espanyol,2024
396,Irvin Cardona,fr FRA,"FW,MF",27-274,6.7,8,5,2,4,2,6,16,37.5,10,5,1,4,4,12,10,0,Matches,Espanyol,2024
397,Álvaro Aguado,es ESP,MF,29-008,4.8,4,2,2,2,0,2,8,25.0,6,6,1,5,4,8,5,1,Matches,Espanyol,2024
398,Fernando Calero,es ESP,"DF,MF",29-237,5.3,12,6,9,3,0,5,6,83.3,1,11,6,5,13,25,31,0,Matches,Espanyol,2024
399,Justin Smith,ca CAN,MF,22-094,2.3,9,3,3,6,0,4,6,66.7,2,5,1,4,4,13,3,0,Matches,Espanyol,2024
400,Rafael Bauza,es ESP,MF,20-099,2.0,5,3,3,1,1,4,7,57.1,3,3,1,2,0,5,5,0,Matches,Espanyol,2024
401,Pere Milla,es ESP,"MF,FW",32-228,3.5,4,1,3,0,1,0,14,0.0,14,9,2,7,2,6,4,0,Matches,Espanyol,2024
402,Naci Ünüvar,nl NED,"MF,DF",21-330,0.3,2,2,1,1,0,1,2,50.0,1,0,0,0,0,2,0,0,Matches,Espanyol,2024
403,Roger Hinojo,es ESP,DF,20-077,0.1,0,0,0,0,0,0,0,,0,0,0,0,0,0,1,0,Matches,Espanyol,2024
404,Paulo Gazzaniga,ar ARG,GK,33-127,33.5,1,1,1,0,0,1,1,100.0,0,1,0,1,0,1,14,3,Matches,Girona,2024
405,Miguel Gutiérrez,es ESP,"DF,MF",23-286,27.3,37,24,18,16,3,17,37,45.9,20,17,7,10,16,53,34,3,Matches,Girona,2024
406,Daley Blind,nl NED,DF,35-061,26.9,40,23,22,14,4,25,39,64.1,14,29,8,21,23,63,82,1,Matches,Girona,2024
407,Arnau Martinez,es ESP,"DF,MF",22-014,25.7,42,22,25,11,6,26,54,48.1,28,15,6,9,25,67,64,2,Matches,Girona,2024
408,David López,es ESP,DF,35-212,25.0,30,22,20,7,3,17,30,56.7,13,21,11,10,12,42,99,1,Matches,Girona,2024
409,Ladislav Krejčí,cz CZE,DF,26-019,24.1,21,15,17,4,0,12,24,50.0,12,24,19,5,32,53,84,4,Matches,Girona,2024
410,Yangel Herrera,ve VEN,MF,27-115,22.3,57,35,26,25,6,27,53,50.9,26,18,3,15,28,85,43,1,Matches,Girona,2024
411,Iván Martín,es ESP,MF,26-084,20.4,28,16,13,12,3,13,31,41.9,18,17,4,13,11,39,15,1,Matches,Girona,2024
412,Bryan Gil,es ESP,"FW,MF",24-087,19.1,34,20,10,15,9,14,30,46.7,16,24,0,24,10,44,9,4,Matches,Girona,2024
413,Viktor Tsyhankov,ua UKR,"FW,MF",27-175,17.6,17,11,3,6,8,7,16,43.8,9,4,0,4,11,28,11,1,Matches,Girona,2024
414,Donny van de Beek,nl NED,MF,28-021,15.8,29,18,17,7,5,13,26,50.0,13,19,3,16,10,39,12,0,Matches,Girona,2024
415,Oriol Romeu,es ESP,MF,33-227,13.8,32,22,13,16,3,12,22,54.5,10,20,7,13,11,43,18,3,Matches,Girona,2024
416,Abel Ruiz,es ESP,FW,25-101,13.6,6,2,2,2,2,2,5,40.0,3,7,2,5,4,10,7,0,Matches,Girona,2024
417,Arnaut Danjuma,nl NED,"FW,MF",28-098,14.6,8,6,3,3,2,2,7,28.6,5,5,1,4,2,10,4,0,Matches,Girona,2024
418,Yaser Asprilla,co COL,"FW,MF",21-171,12.6,15,9,5,6,4,6,16,37.5,10,10,0,10,5,20,4,1,Matches,Girona,2024
419,Bojan Miovski,mk MKD,FW,25-319,9.5,7,5,2,2,3,2,7,28.6,5,4,0,4,2,9,7,0,Matches,Girona,2024
420,Alejandro Francés,es ESP,DF,22-281,10.6,29,21,15,13,1,22,31,71.0,9,12,5,7,15,44,37,0,Matches,Girona,2024
421,Arthur Melo,br BRA,MF,28-270,7.3,22,9,7,12,3,13,23,56.5,10,4,1,3,5,27,7,1,Matches,Girona,2024
422,Juanpe,es ESP,DF,34-009,6.8,8,5,5,3,0,6,8,75.0,2,14,9,5,8,16,46,1,Matches,Girona,2024
423,Cristhian Stuani,uy URU,FW,38-209,9.2,8,7,1,6,1,4,5,80.0,1,4,1,3,5,13,8,0,Matches,Girona,2024
424,Portu,es ESP,"FW,MF",32-353,6.2,11,5,5,3,3,6,9,66.7,3,6,0,6,0,11,2,0,Matches,Girona,2024
425,Jhon Solis,co COL,MF,20-218,5.2,10,5,3,6,1,5,13,38.5,8,12,1,11,4,14,6,1,Matches,Girona,2024
426,Silvi Clúa,es ESP,MF,20-100,1.8,8,7,4,3,1,4,6,66.7,2,1,0,1,2,10,6,0,Matches,Girona,2024
427,Gabriel Osei Misehouy,nl NED,"FW,MF",19-295,2.9,1,1,0,1,0,0,1,0.0,1,0,0,0,0,1,0,0,Matches,Girona,2024
428,Iker Almena,es ESP,"FW,DF",21-005,0.5,0,0,0,0,0,0,1,0.0,1,1,0,1,0,0,2,0,Matches,Girona,2024
429,Papa Ba,es ESP,MF,20-239,0.5,1,1,1,0,0,0,0,,0,1,0,1,0,1,1,0,Matches,Girona,2024
430,Pau López,es ESP,GK,30-147,0.5,0,0,0,0,0,0,0,,0,0,0,0,0,0,1,0,Matches,Girona,2024
431,Kim Minsu,kr KOR,"MF,FW",19-110,0.2,1,0,0,1,0,0,0,,0,0,0,0,0,1,0,0,Matches,Girona,2024
432,Ferrán Ruiz,es ESP,MF,22-013,0.2,0,0,0,0,0,0,0,,0,2,1,1,1,1,0,0,Matches,Girona,2024
433,Dodi Lukebakio,be BEL,FW,27-227,31.4,21,13,8,8,5,14,26,53.8,12,16,0,16,5,26,16,2,Matches,Sevilla,2024
434,Carmona,es ESP,DF,23-100,30.0,77,55,48,21,8,37,70,52.9,33,32,10,22,63,140,88,3,Matches,Sevilla,2024
435,Loïc Bade,fr FRA,DF,25-028,28.2,43,25,33,10,0,21,29,72.4,8,19,11,8,28,71,153,2,Matches,Sevilla,2024
436,Ørjan Nyland,no NOR,GK,34-241,26.7,3,2,3,0,0,3,5,60.0,2,0,0,0,0,3,11,4,Matches,Sevilla,2024
437,Isaac Romero,es ESP,FW,24-356,23.4,12,6,3,4,5,2,15,13.3,13,18,1,17,7,19,26,0,Matches,Sevilla,2024
438,Adrià Pedrosa,es ESP,DF,26-361,23.5,55,32,33,16,6,30,52,57.7,22,40,9,31,20,75,81,0,Matches,Sevilla,2024
439,Nemanja Gudelj,rs SRB,"MF,DF",33-174,24.3,37,20,12,21,4,18,29,62.1,11,26,10,16,25,62,82,0,Matches,Sevilla,2024
440,Kike Salas,es ESP,DF,23-016,21.4,42,25,21,15,6,23,38,60.5,15,22,12,10,30,72,130,0,Matches,Sevilla,2024
441,Djibril Sow,ch SUI,MF,28-092,20.7,21,12,11,9,1,7,16,43.8,9,15,2,13,22,43,25,1,Matches,Sevilla,2024
442,Lucien Agoume,fr FRA,MF,23-089,19.5,56,24,17,31,8,20,28,71.4,8,25,9,16,31,87,35,0,Matches,Sevilla,2024
443,Saúl Ñíguez,es ESP,MF,30-169,16.2,44,30,15,22,7,11,29,37.9,18,25,2,23,19,63,32,0,Matches,Sevilla,2024
444,Albert Sambi Lokonga,be BEL,MF,25-199,15.6,21,15,10,9,2,10,13,76.9,3,12,1,11,9,30,24,3,Matches,Sevilla,2024
445,Juanlu Sánchez,es ESP,"MF,DF",21-267,15.5,36,26,21,12,3,25,41,61.0,16,17,0,17,12,48,15,0,Matches,Sevilla,2024
446,Peque,es ESP,"MF,FW",22-217,11.4,15,5,4,9,2,6,15,40.0,9,16,0,16,7,22,5,0,Matches,Sevilla,2024
447,Chidera Ejuke,ng NGA,FW,27-127,10.6,19,13,8,9,2,9,20,45.0,11,12,0,12,5,24,8,0,Matches,Sevilla,2024
448,Ruben Vargas,ch SUI,"FW,MF",26-277,7.5,7,4,1,5,1,3,8,37.5,5,9,0,9,3,10,10,0,Matches,Sevilla,2024
449,Álvaro Fernández,es ESP,GK,27-026,7.3,0,0,0,0,0,0,1,0.0,1,0,0,0,0,0,7,0,Matches,Sevilla,2024
450,Tanguy Nianzou,fr FRA,DF,22-336,5.8,7,5,6,0,1,5,6,83.3,1,1,0,1,8,15,27,0,Matches,Sevilla,2024
451,Marcão,br BRA,DF,28-338,5.1,9,6,6,3,0,2,3,66.7,1,9,6,3,6,15,27,1,Matches,Sevilla,2024
452,Kelechi Iheanacho,ng NGA,FW,28-218,4.4,1,0,0,1,0,1,3,33.3,2,0,0,0,0,1,1,0,Matches,Sevilla,2024
453,Jesús Navas,es ESP,"FW,MF",39-169,4.7,5,2,3,0,2,0,3,0.0,3,1,0,1,4,9,6,0,Matches,Sevilla,2024
454,Valentín Barco,ar ARG,"DF,FW",20-290,3.2,15,9,8,3,4,12,15,80.0,3,0,0,0,2,17,5,0,Matches,Sevilla,2024
455,Stanis Idumbo,be BEL,"FW,MF",19-314,3.2,9,5,3,4,2,3,5,60.0,2,3,1,2,4,13,2,0,Matches,Sevilla,2024
456,Lucas Ocampos,ar ARG,FW,30-302,1.9,3,2,2,0,1,1,2,50.0,1,2,0,2,0,3,2,0,Matches,Sevilla,2024
457,Suso,es ESP,"FW,MF",31-171,3.5,3,1,2,1,0,1,5,20.0,4,3,0,3,2,5,0,0,Matches,Sevilla,2024
458,Álvaro Pascual,es ESP,FW,23-128,2.2,1,0,0,0,1,1,2,50.0,1,0,0,0,2,3,0,0,Matches,Sevilla,2024
459,Akor Adams,ng NGA,FW,25-100,1.5,0,0,0,0,0,0,0,,0,1,0,1,0,0,1,0,Matches,Sevilla,2024
460,Manu Bueno,es ESP,"MF,FW",20-286,1.3,4,3,0,1,3,1,2,50.0,1,0,0,0,0,4,2,0,Matches,Sevilla,2024
461,Gonzalo Montiel,ar ARG,"DF,MF",28-128,1.3,4,2,3,1,0,3,4,75.0,1,0,0,0,2,6,11,0,Matches,Sevilla,2024
462,Ramón Martínez,es ESP,DF,22-199,1.1,2,1,1,1,0,0,0,,0,0,0,0,2,4,14,0,Matches,Sevilla,2024
463,Diego Iturralde,es ESP,FW,22-023,0.4,0,0,0,0,0,0,0,,0,0,0,0,1,1,1,0,Matches,Sevilla,2024
464,Israel Domínguez,es ESP,FW,22-002,0.2,0,0,0,0,0,0,0,,0,0,0,0,0,0,0,0,Matches,Sevilla,2024
465,Leandro Antonetti,pr PUR,FW,22-116,0.1,0,0,0,0,0,0,0,,0,0,0,0,0,0,0,0,Matches,Sevilla,2024
466,Mateo Mejía,es ESP,FW,22-039,0.1,0,0,0,0,0,0,0,,0,0,0,0,0,0,0,0,Matches,Sevilla,2024
467,Darío Fuentes,es ESP,DF,22-117,0.1,0,0,0,0,0,0,0,,0,0,0,0,0,0,0,0,Matches,Sevilla,2024
468,Carlos Vicente,es ESP,"FW,MF",26-016,30.4,41,26,23,10,8,23,57,40.4,34,28,2,26,13,54,37,0,Matches,Alaves,2024
469,Nahuel Tenaglia,ar ARG,DF,29-077,29.3,87,52,54,28,5,46,75,61.3,29,29,7,22,37,124,115,2,Matches,Alaves,2024
470,Abdel Abqar,ma MAR,DF,26-060,27.4,36,23,24,11,1,20,34,58.8,14,28,18,10,39,75,146,1,Matches,Alaves,2024
471,Antonio Sivera,es ESP,GK,28-271,27.2,2,1,2,0,0,2,2,100.0,0,1,0,1,0,2,17,0,Matches,Alaves,2024
472,Antonio Blanco,es ESP,MF,24-290,26.6,60,37,20,36,4,31,71,43.7,40,27,6,21,39,99,43,1,Matches,Alaves,2024
473,Kiké,es ESP,FW,35-165,25.6,17,12,1,11,5,5,11,45.5,6,9,2,7,1,18,22,0,Matches,Alaves,2024
474,Manu Sánchez,es ESP,DF,24-258,25.5,69,45,34,25,10,35,57,61.4,22,46,9,37,28,97,61,1,Matches,Alaves,2024
475,Jon Guridi,es ESP,"MF,FW",30-070,20.0,33,17,6,21,6,15,39,38.5,24,19,1,18,12,45,11,0,Matches,Alaves,2024
476,Moussa Diarra,ml MLI,DF,24-180,19.7,38,23,19,16,3,17,28,60.7,11,14,5,9,21,59,40,1,Matches,Alaves,2024
477,Ander Guevara,es ESP,MF,27-306,18.6,43,26,18,24,1,18,42,42.9,24,19,5,14,11,54,40,1,Matches,Alaves,2024
478,Santiago Mouriño,uy URU,DF,23-085,17.5,34,24,26,8,0,18,32,56.3,14,25,11,14,25,59,102,0,Matches,Alaves,2024
479,Carlos Martín,es ESP,"FW,MF",23-017,14.5,39,20,15,16,8,13,49,26.5,36,30,1,29,5,44,18,0,Matches,Alaves,2024
480,Joan Jordán,es ESP,MF,30-307,15.1,31,17,11,16,4,16,29,55.2,13,12,0,12,8,39,20,0,Matches,Alaves,2024
481,Tomás Conechny,ar ARG,"FW,MF",27-040,8.8,12,9,4,6,2,8,24,33.3,16,13,2,11,6,18,8,0,Matches,Alaves,2024
482,Carles Aleñá,es ESP,"MF,FW",27-124,8.5,17,10,6,6,5,7,15,46.7,8,7,0,7,2,19,3,0,Matches,Alaves,2024
483,Toni Martínez,es ESP,"FW,MF",27-313,10.1,11,6,4,4,3,3,4,75.0,1,7,2,5,0,11,11,0,Matches,Alaves,2024
484,Stoichkov,es ESP,"MF,FW",31-185,7.8,14,9,6,7,1,6,11,54.5,5,2,0,2,1,15,7,0,Matches,Alaves,2024
485,Aleksandar Sedlar,rs SRB,DF,33-147,5.7,17,9,7,10,0,8,10,80.0,2,2,1,1,9,26,18,1,Matches,Alaves,2024
486,Jesús Owono,gq EQG,GK,24-069,5.4,1,1,1,0,0,1,1,100.0,0,0,0,0,0,1,2,0,Matches,Alaves,2024
487,Pica,es ESP,DF,23-128,5.4,9,7,7,2,0,4,9,44.4,5,7,6,1,8,17,23,0,Matches,Alaves,2024
488,Carlos Benavídez,uy URU,MF,27-040,4.4,12,9,6,4,2,4,8,50.0,4,4,2,2,8,20,11,1,Matches,Alaves,2024
489,Abderrahman Rebbach,dz ALG,"FW,MF",26-271,4.3,3,2,3,0,0,0,6,0.0,6,4,0,4,0,3,6,0,Matches,Alaves,2024
490,Facundo Garcés,ar ARG,DF,25-246,3.5,2,0,2,0,0,1,2,50.0,1,6,5,1,2,4,28,0,Matches,Alaves,2024
491,Asier Villalibre,es ESP,FW,27-221,3.5,1,1,0,0,1,1,2,50.0,1,1,0,1,1,2,7,0,Matches,Alaves,2024
492,Hugo Novoa,es ESP,"DF,MF",22-128,2.6,8,5,4,3,1,5,5,100.0,0,2,1,1,0,8,6,0,Matches,Alaves,2024
493,Luka Romero,ar ARG,"FW,MF",20-172,2.2,4,4,1,1,2,2,3,66.7,1,2,0,2,1,5,0,0,Matches,Alaves,2024
494,Pau Cabanes,es ESP,"MF,FW",20-081,2.0,7,2,4,2,1,5,11,45.5,6,1,0,1,0,7,1,0,Matches,Alaves,2024
495,Adrian Rodriguez,es ESP,GK,24-148,1.4,0,0,0,0,0,0,1,0.0,1,0,0,0,0,0,3,1,Matches,Alaves,2024
496,Luis Rioja,es ESP,FW,31-205,0.3,2,1,0,1,1,1,2,50.0,1,2,0,2,0,2,0,0,Matches,Alaves,2024
497,Alberto Moleiro,es ESP,"FW,MF",21-221,27.4,25,11,10,14,1,18,48,37.5,30,23,0,23,16,41,8,0,Matches,Las Palmas,2024
498,Álex Suárez,es ESP,DF,32-052,25.8,39,22,29,9,1,20,27,74.1,7,35,21,14,12,51,100,1,Matches,Las Palmas,2024
499,Javier Muñoz,es ESP,"MF,DF",30-070,27.8,43,34,18,15,10,15,43,34.9,28,24,4,20,29,72,36,3,Matches,Las Palmas,2024
500,Jasper Cillessen,nl NED,GK,36-017,25.9,1,0,1,0,0,1,4,25.0,3,0,0,0,0,1,11,2,Matches,Las Palmas,2024
501,Scott McKenna,sct SCO,DF,28-178,25.4,18,12,13,5,0,9,12,75.0,3,34,26,8,9,27,146,2,Matches,Las Palmas,2024
502,Mika Mármol,es ESP,DF,23-312,23.7,53,23,31,20,2,29,43,67.4,14,41,13,28,36,89,105,2,Matches,Las Palmas,2024
503,Sandro Ramírez,es ESP,"FW,MF",29-304,21.4,26,15,9,13,4,13,29,44.8,16,18,0,18,16,42,21,2,Matches,Las Palmas,2024
504,Fábio Silva,pt POR,FW,22-294,20.7,12,7,4,5,3,4,14,28.6,10,12,0,12,4,16,27,0,Matches,Las Palmas,2024
505,Dario Essugo,pt POR,MF,20-056,18.9,54,42,27,22,5,26,43,60.5,17,24,9,15,41,95,43,7,Matches,Las Palmas,2024
506,Kirian Rodríguez,es ESP,MF,29-065,19.5,33,17,12,18,3,22,43,51.2,21,22,4,18,10,43,21,0,Matches,Las Palmas,2024
507,Viti,es ESP,DF,27-235,19.5,65,43,41,17,7,29,43,67.4,14,26,6,20,24,89,52,0,Matches,Las Palmas,2024
508,Oliver McBurnie,sct SCO,FW,28-339,17.4,13,7,5,6,2,5,11,45.5,6,14,5,9,5,18,21,0,Matches,Las Palmas,2024
509,Álex Muñoz,es ESP,DF,30-283,15.2,38,29,22,15,1,20,37,54.1,17,28,11,17,16,54,68,0,Matches,Las Palmas,2024
510,José Campaña,es ESP,MF,31-343,12.2,18,14,7,9,2,9,16,56.3,7,8,0,8,18,36,19,2,Matches,Las Palmas,2024
511,Juan Herzog,es ESP,DF,21-361,10.7,11,11,11,0,0,9,14,64.3,5,13,8,5,14,25,54,0,Matches,Las Palmas,2024
512,Stefan Bajcetic,es ESP,"MF,DF",20-199,9.3,25,13,12,10,3,9,24,37.5,15,24,4,20,14,39,24,1,Matches,Las Palmas,2024
513,Marvin,es ESP,"DF,FW",24-310,9.1,21,10,10,7,4,9,22,40.9,13,15,5,10,9,30,25,0,Matches,Las Palmas,2024
514,Dinko Horkaš,hr CRO,GK,26-060,8.1,0,0,0,0,0,0,0,,0,0,0,0,0,0,6,1,Matches,Las Palmas,2024
515,Manuel Fuster,es ESP,"FW,MF",27-199,8.8,16,8,3,8,5,14,26,53.8,12,13,3,10,4,20,14,0,Matches,Las Palmas,2024
516,Enzo Loiodice,fr FRA,MF,24-163,5.6,11,4,6,5,0,3,9,33.3,6,4,1,3,5,16,7,2,Matches,Las Palmas,2024
517,Jaime Mata,es ESP,FW,36-197,5.9,6,1,1,5,0,3,9,33.3,6,4,1,3,3,9,9,0,Matches,Las Palmas,2024
518,Adnan Januzaj,be BEL,"MF,FW",30-093,4.5,9,5,1,5,3,5,7,71.4,2,5,0,5,0,9,2,0,Matches,Las Palmas,2024
519,Andy Pelmard,fr FRA,DF,25-058,2.3,5,0,3,2,0,4,5,80.0,1,3,1,2,2,7,20,0,Matches,Las Palmas,2024
520,Benito Ramírez,es ESP,"DF,MF",29-302,4.3,10,5,4,6,0,9,16,56.3,7,6,3,3,1,11,14,1,Matches,Las Palmas,2024
521,Daley Sinkgraven,nl NED,DF,29-309,1.0,5,1,3,2,0,1,3,33.3,2,1,0,1,1,6,2,0,Matches,Las Palmas,2024
522,Marc Cardona,es ESP,"FW,DF",29-305,1.2,2,1,1,1,0,0,1,0.0,1,0,0,0,0,2,0,0,Matches,Las Palmas,2024
523,Fabio González,es ESP,MF,28-086,0.6,0,0,0,0,0,0,1,0.0,1,0,0,0,0,0,0,0,Matches,Las Palmas,2024
524,Pejiño,es ESP,FW,28-284,0.2,1,1,0,1,0,1,1,100.0,0,0,0,0,0,1,0,0,Matches,Las Palmas,2024
525,Valentín Pezzolesi,es ESP,DF,18-023,0.1,0,0,0,0,0,0,0,,0,0,0,0,0,0,1,1,Matches,Las Palmas,2024
526,Aboubacar Bassinga,ci CIV,MF,19-300,0.0,0,0,0,0,0,0,0,,0,0,0,0,0,0,0,0,Matches,Las Palmas,2024
527,Sergi,es ESP,DF,33-019,31.4,38,28,22,15,1,17,31,54.8,14,35,28,7,39,77,182,2,Matches,Leganes,2024
528,Marko Dmitrović,rs SRB,GK,33-105,28.0,1,1,1,0,0,1,2,50.0,1,0,0,0,0,1,25,3,Matches,Leganes,2024
529,Seydouba Cissé,gn GUI,MF,24-088,23.2,47,30,17,22,8,19,39,48.7,20,23,1,22,11,58,40,1,Matches,Leganes,2024
530,Valentin Rosier,fr FRA,DF,28-263,27.1,69,51,48,15,6,41,66,62.1,25,39,14,25,50,119,143,2,Matches,Leganes,2024
531,Yvan Neyou,cm CMR,MF,28-126,24.1,53,33,21,26,6,22,45,48.9,23,33,5,28,25,78,37,1,Matches,Leganes,2024
532,Javi Hernández,es ESP,DF,27-007,23.5,25,15,16,6,3,16,42,38.1,26,22,3,19,22,47,89,0,Matches,Leganes,2024
533,Renato Tapia,pe PER,"MF,DF",29-285,23.2,54,31,26,24,4,20,43,46.5,23,53,20,33,23,77,73,2,Matches,Leganes,2024
534,Juan Cruz,es ESP,"FW,MF",25-014,23.1,30,19,13,15,2,16,32,50.0,16,14,2,12,11,41,27,0,Matches,Leganes,2024
535,Matija Nastasić,rs SRB,DF,32-042,22.6,24,11,21,3,0,16,24,66.7,8,39,30,9,19,43,155,0,Matches,Leganes,2024
536,Dani Raba,es ESP,"FW,MF",29-192,18.1,34,21,16,14,4,15,37,40.5,22,25,2,23,14,48,14,1,Matches,Leganes,2024
537,Miguel,es ESP,FW,25-248,18.6,16,7,6,4,6,4,14,28.6,10,14,4,10,4,20,23,1,Matches,Leganes,2024
538,Darko Brašanac,rs SRB,MF,33-086,17.3,26,11,5,15,6,9,17,52.9,8,24,11,13,15,41,31,0,Matches,Leganes,2024
539,Jorge Sáenz,es ESP,DF,28-173,14.8,30,21,15,14,1,8,14,57.1,6,22,14,8,21,51,138,0,Matches,Leganes,2024
540,Adrià Altimira,es ESP,"DF,FW",24-042,14.1,32,16,21,9,2,17,31,54.8,14,11,6,5,14,46,43,2,Matches,Leganes,2024
541,Óscar Rodríguez Arnaiz,es ESP,"MF,FW",26-315,13.9,31,16,10,15,6,13,29,44.8,16,9,1,8,18,49,18,0,Matches,Leganes,2024
542,Diego,es ESP,"FW,MF",25-021,10.3,0,0,0,0,0,0,4,0.0,4,3,1,2,2,2,10,0,Matches,Leganes,2024
543,Munir El Haddadi,ma MAR,"FW,MF",29-250,7.4,11,8,5,4,2,3,10,30.0,7,6,1,5,1,12,1,1,Matches,Leganes,2024
544,Enric Franquesa,es ESP,"DF,FW",28-072,6.8,17,9,9,6,2,9,13,69.2,4,7,1,6,5,22,12,0,Matches,Leganes,2024
545,Juan Soriano,es ESP,GK,27-259,6.0,1,1,1,0,0,1,1,100.0,0,0,0,0,0,1,2,0,Matches,Leganes,2024
546,Sébastien Haller,ci CIV,FW,30-321,4.5,2,0,1,0,1,1,2,50.0,1,1,0,1,0,2,7,0,Matches,Leganes,2024
547,Roberto López,es ESP,MF,25-015,4.4,8,6,4,4,0,5,15,33.3,10,5,0,5,1,9,7,2,Matches,Leganes,2024
548,Yan Diomandé,ci CIV,"FW,MF",18-176,2.6,2,1,1,0,1,1,7,14.3,6,6,0,6,3,5,2,0,Matches,Leganes,2024
549,Julián Chicco,ar ARG,"MF,DF",27-116,3.3,11,7,3,6,2,5,8,62.5,3,2,0,2,3,14,9,0,Matches,Leganes,2024
550,Aritz Arambarri,es ESP,DF,27-098,2.0,1,1,1,0,0,1,1,100.0,0,2,2,0,3,4,8,0,Matches,Leganes,2024
551,Duk,cv CPV,"MF,FW",25-082,1.6,6,3,1,3,2,2,4,50.0,2,3,0,3,0,6,2,0,Matches,Leganes,2024
552,Borna Barišić,hr CRO,DF,32-180,0.1,0,0,0,0,0,0,0,,0,0,0,0,0,0,0,0,Matches,Leganes,2024
553,Karl Jakob Hein,ee EST,GK,23-026,28.0,0,0,0,0,0,0,2,0.0,2,0,0,0,0,0,17,1,Matches,Valladolid,2024
554,Luis Pérez,es ESP,DF,30-094,26.9,38,27,23,10,5,24,40,60.0,16,26,9,17,28,66,76,0,Matches,Valladolid,2024
555,Javi Sánchez,es ESP,DF,28-056,22.5,26,16,19,6,1,17,26,65.4,9,39,28,11,22,48,111,3,Matches,Valladolid,2024
556,Raúl Moro,es ESP,"MF,FW",22-155,22.2,18,11,13,2,3,10,26,38.5,16,6,0,6,10,28,14,0,Matches,Valladolid,2024
557,Lucas Oliveira Rosa,br BRA,DF,25-036,21.0,53,33,40,11,2,35,51,68.6,16,24,9,15,28,81,69,2,Matches,Valladolid,2024
558,Stanko Jurić,hr CRO,MF,28-266,19.2,48,24,26,19,3,19,48,39.6,29,35,11,24,24,72,52,0,Matches,Valladolid,2024
559,Mario Martín,es ESP,MF,21-065,17.9,59,30,29,27,3,20,45,44.4,25,28,6,22,19,78,39,7,Matches,Valladolid,2024
560,Eray Cömert,ch SUI,"DF,MF",27-094,16.9,21,12,13,8,0,11,18,61.1,7,25,15,10,21,42,60,1,Matches,Valladolid,2024
561,Anuar,ma MAR,"MF,FW",30-114,16.6,34,23,20,9,5,13,26,50.0,13,22,7,15,15,49,19,1,Matches,Valladolid,2024
562,Mamadou Sylla,sn SEN,"FW,MF",31-050,16.5,6,3,2,2,2,2,8,25.0,6,6,0,6,3,9,12,1,Matches,Valladolid,2024
563,Selim Amallah,ma MAR,MF,28-175,14.0,27,15,9,17,1,9,17,52.9,8,20,1,19,14,41,4,1,Matches,Valladolid,2024
564,David Torres,es ESP,DF,22-065,15.4,13,8,12,1,0,7,11,63.6,4,19,17,2,10,23,74,0,Matches,Valladolid,2024
565,Kike Pérez,es ESP,MF,28-084,13.2,37,26,15,19,3,15,26,57.7,11,16,4,12,7,44,18,0,Matches,Valladolid,2024
566,Marcos André,br BRA,FW,28-201,13.1,10,6,3,5,2,5,13,38.5,8,18,2,16,3,13,10,0,Matches,Valladolid,2024
567,Iván Sánchez,es ESP,"MF,FW",32-228,14.0,34,19,17,9,8,11,26,42.3,15,18,3,15,13,47,10,0,Matches,Valladolid,2024
568,Juanmi Latasa,es ESP,FW,24-047,12.0,3,1,1,1,1,2,5,40.0,3,3,1,2,0,3,10,1,Matches,Valladolid,2024
569,Juma Bah,sl SLE,DF,19-028,9.6,10,7,7,3,0,3,5,60.0,2,15,8,7,12,22,60,0,Matches,Valladolid,2024
570,Antonio Candela,it ITA,DF,25-012,8.0,8,6,5,2,1,3,7,42.9,4,9,5,4,6,14,20,0,Matches,Valladolid,2024
571,Adam Aznou,ma MAR,DF,18-341,7.5,24,19,18,6,0,19,36,52.8,17,21,7,14,7,31,17,0,Matches,Valladolid,2024
572,Chuky san jose,es ESP,MF,21-010,7.2,8,2,3,3,2,2,9,22.2,7,4,1,3,0,8,2,0,Matches,Valladolid,2024
573,Darwin Machís,ve VEN,"MF,FW",32-091,6.9,5,4,3,2,0,3,9,33.3,6,3,0,3,5,10,13,0,Matches,Valladolid,2024
574,Tamás Nikitscher,hu HUN,MF,25-187,6.3,14,6,8,6,0,7,10,70.0,3,10,2,8,9,23,9,0,Matches,Valladolid,2024
575,Florian Grillitsch,at AUT,MF,29-275,5.3,8,6,5,3,0,5,13,38.5,8,10,1,9,4,12,5,1,Matches,Valladolid,2024
576,Joseph Aidoo,gh GHA,DF,29-222,6.0,5,5,3,2,0,2,3,66.7,1,6,3,3,4,9,22,1,Matches,Valladolid,2024
577,André Ferreira,pt POR,GK,28-345,5.0,0,0,0,0,0,0,0,,0,0,0,0,0,0,4,2,Matches,Valladolid,2024
578,Cenk Özkacar,tr TUR,DF,24-215,4.9,5,3,4,1,0,2,6,33.3,4,6,4,2,11,16,39,1,Matches,Valladolid,2024
579,Amath,sn SEN,"FW,DF",28-297,3.9,2,0,2,0,0,1,7,14.3,6,7,1,6,2,4,6,0,Matches,Valladolid,2024
580,Enzo Boyomo,cm CMR,DF,23-214,3.0,6,2,4,2,0,3,3,100.0,0,4,3,1,1,7,7,0,Matches,Valladolid,2024
581,Víctor Meseguer,es ESP,MF,25-334,4.6,10,6,4,4,2,2,10,20.0,8,3,0,3,2,12,4,1,Matches,Valladolid,2024
582,Henrique,br BRA,DF,31-014,2.2,3,2,2,1,0,0,3,0.0,3,5,0,5,2,5,5,0,Matches,Valladolid,2024
583,Raúl Chasco,es ESP,DF,21-238,1.4,4,1,3,1,0,2,4,50.0,2,1,0,1,2,6,2,0,Matches,Valladolid,2024
584,Arnau Rafús,es ESP,GK,22-012,1.0,0,0,0,0,0,0,0,,0,0,0,0,0,0,0,1,Matches,Valladolid,2024
585,Mario Maroto,es ESP,MF,21-162,0.2,0,0,0,0,0,0,1,0.0,1,0,0,0,2,2,1,0,Matches,Valladolid,2024
586,Adrian Baquerin,es ESP,FW,18-066,0.1,0,0,0,0,0,0,0,,0,0,0,0,0,0,1,0,Matches,Valladolid,2024
587,Kenedy,br BRA,"MF,FW",29-090,0.1,0,0,0,0,0,0,0,,0,1,0,1,0,0,0,0,Matches,Valladolid,2024
